150 30
35 35 35 35 35 35 35 35 35 35 35 35 35 35 35 35 35 35 35 35 35 35 35 35 35 35 35 35 35 35 35 35 35 35 35 35 35 35 35 35 35 35 35 35 35 35 35 35 35 35 35 35 35 35 35 35 26 35 35 35 35 35 35 35 35 35 35 35 35 35 35 26 35 35 35 35 35 35 35 35 35 35 35 35 35 35 35 26 35 35 35 35 35 26 35 35 35 35 35 35 35 35 35 35 35 35 35 35 35 35 35 35 35 35 35 35 35 35 35 35 35 35 26 26 35 35 35 35 35 35 35 35 35 35 35 35 35 35 35 35 35 35 35 35 35 35 35 35 35 35
35 35 35 35 35 35 35 35 35 35 35 35 35 35 35 35 35 35 35 35 35 35 35 35 35 26 35 35 35 35 35 26 35 35 35 35 35 26 35 26 35 35 26 35 35 35 35 35 35 35 35 35 35 35 35 35 35 35 35 26 35 35 35 35 26 35 35 35 35 35 35 35 35 35 35 35 35 35 35 35 35 26 35 35 35 35 35 35 35 35 35 35 35 35 35 35 35 35 35 26 26 35 35 26 35 35 35 35 35 35 35 35 35 35 26 35 35 35 26 35 35 35 35 35 35 35 35 35 35 35 35 35 35 35 35 35 35 35 35 35 35 35 35 35 35 35 26 35 35 35
35 35 35 35 35 35 35 35 35 35 35 35 35 35 35 35 35 35 35 35 35 35 35 35 35 35 35 35 35 35 35 35 35 35 35 26 35 35 35 35 35 35 35 35 35 35 35 26 35 35 35 35 39 35 35 35 35 35 35 35 35 35 26 35 35 26 35 35 26 35 26 35 35 35 26 35 35 35 35 35 26 35 35 35 35 35 35 35 35 35 35 35 35 35 35 35 35 35 35 35 35 35 35 35 26 35 35 35 35 26 35 35 35 35 35 35 26 35 35 35 35 35 35 35 35 35 35 35 35 35 35 35 35 26 35 35 35 35 39 35 26 35 35 35 26 35 35 35 35 35
35 35 35 35 35 35 35 35 35 35 35 35 35 35 35 35 35 35 35 35 35 35 35 35 35 35 35 35 26 35 26 35 35 35 35 35 35 26 35 35 35 35 35 35 35 35 26 35 35 26 35 35 35 35 35 35 35 35 35 35 35 26 35 35 35 35 35 35 35 35 35 35 35 35 26 35 26 35 35 35 35 35 35 35 35 35 35 35 35 35 35 35 35 35 35 35 35 26 35 26 35 35 35 35 35 26 35 35 35 35 35 35 35 35 35 35 35 35 35 35 35 35 26 35 35 35 35 35 35 35 35 35 35 35 35 35 35 35 35 35 35 35 35 35 35 35 35 35 35 35
35 35 35 35 35 35 35 35 35 35 35 35 35 35 35 35 35 35 35 35 35 35 35 35 35 35 35 35 35 35 35 35 35 26 35 35 35 35 35 35 35 35 35 35 26 35 35 35 35 35 35 35 35 35 35 35 35 35 35 26 35 35 35 35 35 35 35 35 35 35 35 35 35 35 35 35 35 35 35 35 35 35 26 35 26 35 35 35 35 35 35 39 35 35 35 26 35 35 35 35 35 35 35 35 35 35 35 35 35 26 35 35 35 35 26 35 35 35 35 35 35 35 35 35 26 35 26 35 35 35 35 35 26 35 35 35 35 35 35 35 35 35 35 35 35 35 35 35 26 35
35 35 35 35 35 35 35 35 35 35 35 35 35 35 35 35 35 35 35 35 35 35 35 35 35 35 35 35 35 35 35 35 35 35 26 35 35 26 35 26 35 26 35 35 35 35 35 35 35 35 35 35 26 35 35 35 26 35 35 35 35 35 40 35 35 35 26 35 35 26 35 35 35 35 35 26 35 35 35 35 26 35 35 35 35 35 35 26 35 35 35 35 35 26 35 35 35 35 35 35 35 35 35 35 26 35 35 26 35 35 35 35 35 35 35 35 26 35 35 35 40 35 35 35 35 26 35 35 26 35 35 35 35 35 35 35 35 35 35 35 35 35 35 35 35 40 35 35 35 35
35 35 35 35 35 35 35 35 35 35 35 35 35 35 35 35 35 35 35 35 35 35 35 35 35 35 26 35 35 26 35 35 35 35 35 35 35 35 35 35 35 35 35 35 35 35 35 35 35 26 35 35 35 35 35 35 35 35 35 35 35 35 35 26 35 35 35 35 35 35 35 35 26 35 35 35 35 35 35 26 35 35 35 35 35 35 35 35 35 35 35 35 35 35 35 26 35 35 35 35 35 39 35 35 35 35 35 35 35 26 35 35 35 26 26 35 35 35 35 35 35 35 35 35 35 26 35 35 26 26 35 35 35 26 35 35 35 35 35 35 35 26 35 35 35 35 35 35 35 35
35 35 35 35 35 35 35 35 35 35 35 35 35 35 35 35 35 35 35 35 35 35 35 35 35 35 35 35 35 35 35 35 35 35 35 35 26 35 35 35 35 35 35 35 35 26 35 35 35 35 35 26 35 35 35 35 35 35 35 35 26 35 35 35 35 35 26 35 35 35 35 35 35 35 35 35 35 35 35 35 35 35 35 26 35 35 35 35 35 35 35 35 35 35 35 35 35 26 35 35 35 35 35 26 35 35 35 35 35 35 35 35 26 35 35 35 35 35 35 35 35 26 35 35 35 35 35 35 35 35 35 35 35 35 35 35 35 35 35 26 35 35 35 35 35 35 35 35 26 35
35 35 35 35 35 35 35 35 35 35 35 35 35 35 35 35 35 35 35 35 35 35 35 35 35 35 35 35 35 26 35 35 35 26 35 35 35 35 35 35 35 35 35 35 35 35 35 35 40 35 35 35 35 35 35 35 35 35 35 35 35 26 35 35 35 35 35 26 35 35 35 35 35 35 35 26 35 35 35 35 35 35 35 35 35 35 35 35 35 35 35 35 35 35 35 35 35 35 35 35 26 35 35 35 35 35 35 26 35 35 26 35 26 35 35 35 35 39 35 35 35 35 35 35 35 35 35 26 35 35 35 35 26 35 35 35 35 35 35 35 35 35 35 35 35 26 35 35 35 35
35 35 35 35 35 35 35 35 35 35 35 35 35 35 35 35 35 35 35 35 35 35 35 35 35 35 35 35 35 35 35 35 26 35 26 35 35 39 26 35 26 35 35 26 35 35 35 35 35 35 35 35 35 26 35 35 35 35 35 26 35 35 35 35 35 35 35 35 35 26 35 35 35 35 26 35 35 35 35 35 35 26 35 35 26 35 35 35 35 35 35 26 35 26 35 35 35 35 35 35 35 35 35 35 35 35 35 35 35 35 35 35 35 35 35 35 26 35 35 35 35 35 35 35 35 35 35 35 35 35 35 26 35 35 26 35 35 35 35 35 35 26 35 35 35 35 35 26 35 35
35 35 35 35 35 35 35 35 35 35 35 35 35 35 35 35 35 35 35 35 35 35 35 35 35 35 26 26 35 35 35 35 35 35 35 35 35 35 35 35 35 35 35 35 35 35 26 35 35 35 35 35 35 35 35 40 35 35 35 35 35 35 35 26 35 35 26 35 35 35 35 26 35 35 35 35 35 35 35 35 35 35 35 35 35 35 35 35 35 35 35 35 35 35 35 26 35 35 35 35 35 35 35 35 26 35 35 26 35 35 35 35 35 26 35 35 35 35 35 26 35 35 35 35 26 35 35 35 26 35 35 35 35 35 35 35 35 35 26 35 35 35 35 35 35 35 35 35 35 35
35 35 35 35 35 35 35 35 35 35 35 35 35 35 35 35 35 35 35 35 35 35 35 35 35 35 35 35 35 35 35 35 35 35 35 35 35 35 35 35 35 35 35 35 35 35 35 35 35 35 35 35 35 26 35 35 35 35 35 35 35 35 35 35 35 35 35 35 35 35 35 35 35 35 35 35 26 35 35 26 35 35 35 35 35 35 35 35 35 26 35 35 35 35 35 35 35 35 35 40 35 35 26 35 35 35 35 35 35 35 35 7 25 35 35 35 35 35 26 35 35 35 26 35 35 35 35 35 35 35 35 35 26 35 35 35 35 35 35 35 35 26 26 35 35 35 35 35 35 35
35 35 35 35 35 35 35 35 35 35 35 35 35 35 35 35 35 35 35 35 35 35 35 35 35 35 35 35 35 35 35 35 35 35 35 35 35 35 35 35 35 35 35 35 35 35 35 35 35 35 35 35 35 35 35 35 35 35 35 35 35 35 35 35 35 35 35 35 35 35 35 35 35 26 35 35 35 35 35 35 35 35 35 26 35 35 40 35 35 35 35 26 35 35 35 26 35 35 35 26 40 35 35 35 35 35 35 26 35 35 24 7 35 35 35 35 26 35 35 26 35 35 35 35 35 26 35 35 35 35 35 35 35 35 35 39 35 35 35 35 35 35 35 35 35 35 26 35 35 35
35 35 35 35 35 35 35 35 35 35 35 35 35 35 35 35 35 35 35 35 35 35 35 35 35 35 35 35 35 35 35 35 35 35 35 35 35 35 35 35 35 35 35 35 35 35 35 35 35 39 35 35 35 35 35 35 35 26 35 35 35 35 35 35 35 35 35 35 35 35 35 35 35 35 35 35 35 35 26 35 26 35 35 35 35 35 35 35 35 35 35 35 35 35 35 35 35 35 35 35 35 35 35 35 35 26 35 35 35 35 35 7 35 26 35 35 35 35 35 35 35 35 26 35 35 35 35 35 26 35 26 35 35 35 35 35 35 35 26 35 35 40 40 35 35 35 26 35 35 35
35 35 35 35 35 35 35 35 35 35 35 35 35 35 35 35 35 35 35 35 35 35 35 35 35 35 26 35 35 26 35 35 35 35 35 35 35 35 35 35 35 35 35 35 35 35 35 35 35 35 35 35 35 35 35 35 35 35 35 35 35 35 35 35 35 35 35 35 35 35 26 35 35 35 35 35 35 35 35 35 35 35 35 26 35 35 35 35 26 35 35 35 26 35 35 35 35 26 35 35 35 35 35 35 35 35 35 35 35 35 0 0 0 0 0 0 0 0 35 35 35 35 35 35 35 35 35 35 35 35 35 35 35 35 35 26 35 35 35 35 35 35 35 35 35 35 35 35 35 35
35 35 35 35 35 35 35 35 35 35 35 35 35 35 35 35 35 26 35 35 39 35 26 35 35 35 26 35 35 35 35 35 35 35 35 35 35 35 35 35 35 35 35 35 35 35 35 35 35 35 35 35 35 35 35 35 26 40 35 35 35 35 35 35 35 35 26 35 35 35 35 35 35 26 35 35 26 35 35 35 35 35 35 35 35 35 35 35 35 35 35 35 35 35 35 35 35 35 35 35 35 35 35 35 35 35 35 35 0 0 0 0 0 0 0 0 0 0 0 35 35 35 26 35 35 26 35 35 0 0 0 0 0 35 35 35 35 35 35 35 35 35 35 26 35 35 35 35 26 35
35 35 35 35 35 35 35 35 35 35 35 35 39 35 35 35 35 35 35 35 35 35 35 35 35 35 35 35 35 35 35 35 35 35 35 35 35 35 35 35 26 35 35 35 35 35 35 35 35 35 35 35 35 26 35 35 35 35 35 35 35 35 35 35 35 35 35 35 35 35 35 35 35 35 35 35 35 0 0 0 0 0 0 0 0 35 35 35 35 35 35 35 35 35 35 35 35 35 35 35 35 26 35 35 7 35 0 0 0 0 0 0 0 0 0 0 0 0 0 0 0 35 35 26 35 35 35 0 0 16 16 16 0 0 35 35 35 35 35 35 26 35 35 35 35 35 26 35 35 35
35 35 35 35 35 35 35 35 35 35 35 35 35 35 35 35 35 35 35 35 35 35 35 35 35 35 35 35 26 35 26 35 26 35 35 35 35 35 35 35 35 35 35 35 35 26 35 35 35 35 26 35 35 35 35 35 35 35 35 35 35 35 40 35 35 35 35 35 35 35 24 25 7 35 35 35 0 0 0 0 0 0 0 0 0 0 0 35 35 35 35 35 26 35 35 39 35 26 35 35 35 35 35 24 7 0 0 0 0 0 0 0 0 2 2 2 2 2 2 2 0 35 35 35 26 35 35 0 16 41 41 41 16 16 0 35 35 26 35 35 35 35 35 35 35 35 35 35 39 35
35 35 35 35 35 35 35 35 35 35 35 35 35 35 35 35 35 35 35 35 35 35 35 35 26 35 35 35 35 35 35 35 35 35 35 35 35 26 35 35 35 35 35 35 35 35 35 35 35 35 35 35 35 35 35 35 35 35 26 35 35 35 35 35 35 35 26 35 35 35 35 35 7 35 35 0 0 0 0 0 0 0 0 0 0 0 0 0 0 35 35 35 35 35 35 35 35 35 35 35 35 35 35 35 0 0 0 0 0 0 2 2 2 2 16 16 16 16 16 2 2 0 35 35 35 35 0 16 41 41 41 41 41 41 35 35 35 35 35 35 35 35 26 35 26 35 35 35 35 35
26 35 35 34 35 35 35 26 35 35 26 35 35 35 35 26 26 35 35 35 26 35 35 35 35 35 35 35 35 35 35 35 35 26 35 35 35 35 35 35 26 35 35 35 35 35 26 35 35 0 0 0 0 0 0 0 35 35 35 35 35 35 35 35 35 35 35 35 39 35 35 35 7 35 0 0 0 0 0 2 2 2 2 0 0 0 0 0 0 35 35 26 35 35 35 35 35 35 35 35 35 35 35 35 0 0 0 0 2 2 2 2 2 2 16 41 41 41 41 16 2 0 35 0 0 0 0 16 41 41 41 41 41 16 0 0 35 26 35 24 7 35 35 35 35 35 35 35 35 35
35 35 35 35 35 35 39 35 35 35 35 35 35 35 35 35 35 35 35 35 35 35 35 35 26 35 35 35 26 35 35 35 35 35 35 35 35 35 35 35 35 35 35 35 35 35 35 35 0 0 0 0 0 0 0 0 0 0 35 35 35 26 35 35 35 35 35 35 35 35 35 35 0 0 0 0 0 0 2 2 2 2 2 2 2 2 0 0 0 0 35 35 35 35 40 35 35 35 35 35 0 27 27 27 16 2 2 2 2 2 2 2 2 16 16 41 41 41 41 41 16 16 41 16 16 16 16 41 41 41 41 41 16 16 0 0 0 35 35 35 7 25 35 26 35 35 35 35 35 35
35 35 35 35 35 35 35 35 35 35 35 35 7 35 35 35 35 35 35 35 35 35 35 35 35 35 35 35 35 35 35 35 35 26 35 35 35 35 26 35 35 35 35 26 35 35 35 35 0 0 2 2 2 2 2 2 0 0 0 35 35 35 35 35 26 35 35 35 35 35 35 35 0 0 0 0 0 0 2 2 2 2 2 2 2 2 0 0 0 0 0 0 35 35 35 35 35 26 35 0 16 16 16 16 16 2 2 2 2 2 2 2 16 16 16 41 41 41 41 41 41 41 41 41 41 41 41 41 41 41 41 16 16 2 0 0 0 0 0 35 7 35 35 35 35 35 35 35 35 35
35 35 26 35 35 35 35 35 35 35 35 24 7 35 35 35 35 35 0 0 0 0 0 0 0 35 35 35 35 35 35 35 35 35 35 35 35 35 35 35 35 35 26 35 35 35 35 0 0 0 2 16 16 16 16 2 2 2 0 0 35 35 35 35 35 35 35 35 26 35 35 0 0 0 0 0 0 2 2 2 2 16 16 2 2 2 2 0 0 0 0 0 0 35 35 35 35 35 0 0 2 2 2 2 2 2 2 2 2 16 16 16 16 16 16 16 41 41 41 41 41 41 41 41 41 41 41 41 41 41 41 16 2 2 2 0 0 0 0 0 0 0 0 0 0 0 0 0 0 0
35 35 35 35 35 35 35 35 35 35 35 35 7 35 0 0 0 0 0 0 0 0 0 0 0 0 0 0 0 0 35 35 35 35 35 35 26 35 35 35 35 35 35 35 35 35 0 0 0 2 16 16 16 16 16 16 16 16 16 0 0 35 35 26 35 35 35 35 35 35 35 0 0 0 0 0 2 2 2 2 16 16 16 16 2 2 2 2 0 0 0 0 0 0 35 35 35 35 0 0 2 2 2 2 2 2 2 2 2 16 16 16 16 16 16 16 16 41 41 41 41 41 41 41 41 41 41 41 41 41 41 16 2 2 2 0 0 0 0 0 0 0 0 0 0 0 0 0 0 0
35 35 35 35 35 35 26 35 35 35 35 35 0 0 0 0 0 0 0 0 0 0 0 0 0 0 0 0 0 0 0 35 35 35 35 35 35 35 35 35 35 35 35 35 35 0 0 0 2 2 16 41 41 41 41 41 41 41 41 0 0 35 35 35 35 35 35 26 35 35 35 0 0 0 0 0 2 2 2 16 16 16 16 16 16 2 2 2 2 0 0 0 0 0 0 35 35 0 0 0 2 2 2 2 2 2 16 16 16 16 16 16 16 16 16 16 16 41 41 41 41 41 41 41 41 41 41 41 16 16 16 16 16 16 2 2 0 0 0 0 0 0 0 0 0 0 0 0 0 0
35 40 35 35 35 35 35 35 35 35 0 0 0 0 0 0 0 0 0 0 0 0 0 0 0 0 0 0 0 0 0 35 35 39 35 35 26 35 26 35 35 35 26 35 0 0 0 2 2 2 16 41 41 41 41 41 41 41 41 41 35 35 35 35 35 35 35 35 35 35 0 0 0 0 0 2 2 2 2 16 16 16 16 16 16 2 2 2 2 2 0 0 0 0 0 0 0 0 0 2 2 2 2 2 16 16 16 16 16 16 16 16 16 16 16 16 16 41 41 41 41 41 41 41 41 41 41 16 16 16 16 16 16 16 16 2 2 2 2 2 0 0 0 0 0 0 0 0 0 0
27 27 27 27 0 0 0 0 0 0 0 0 0 0 0 0 0 0 0 0 0 0 0 0 0 0 0 0 0 0 0 0 35 35 35 35 35 35 35 35 35 7 35 35 0 0 2 2 2 2 16 41 41 41 41 41 41 41 41 41 35 35 35 35 35 35 35 35 35 35 0 0 0 0 2 2 2 2 16 16 16 16 16 16 16 16 16 2 2 2 2 2 2 0 0 0 0 0 2 2 2 16 16 16 16 16 16 16 16 16 16 16 16 16 16 16 16 16 16 16 16 16 16 16 16 16 16 16 16 16 16 16 16 16 16 16 2 2 2 2 2 2 2 2 2 2 2 2 2 2
15 15 15 15 16 2 2 2 2 2 2 2 2 2 2 2 2 2 2 2 2 2 2 2 2 2 2 2 2 2 2 0 0 35 35 35 35 35 35 35 35 7 35 0 0 2 2 2 2 16 16 16 16 16 16 16 16 16 16 16 0 0 0 0 35 35 35 35 35 0 0 0 0 2 2 2 2 16 16 16 16 16 16 16 16 16 16 16 16 16 2 2 2 2 2 2 2 2 2 2 2 16 16 16 16 16 16 16 16 16 16 16 16 16 16 16 16 16 16 16 16 16 16 16 16 16 16 16 16 16 16 16 16 16 16 16 16 2 2 2 2 2 2 2 2 2 2 2 2 2
15 15 15 15 16 2 2 2 2 2 2 2 2 2 2 2 2 2 2 2 2 2 2 2 2 2 2 2 2 2 2 2 0 0 0 0 27 27 27 27 27 0 0 2 2 2 2 2 16 16 16 16 16 16 16 16 16 16 16 16 16 2 2 0 0 0 0 0 0 0 0 0 2 2 2 16 16 16 16 16 16 16 16 16 16 16 16 16 16 16 16 16 2 2 2 2 2 2 2 2 16 16 16 16 16 16 16 16 16 16 16 16 16 16 16 16 16 16 16 16 16 16 16 16 16 16 16 16 16 16 16 16 16 16 16 16 16 16 2 2 2 2 2 2 2 2 2 2 2 2
16 16 16 16 16 2 2 2 2 2 2 2 2 2 2 2 2 2 2 2 2 2 2 2 2 2 2 2 2 2 2 2 2 2 2 16 16 16 16 16 16 16 2 2 2 2 2 16 16 16 16 16 16 16 16 16 16 16 16 16 16 16 2 2 2 2 2 2 2 2 2 2 2 2 16 16 16 16 16 16 16 16 16 16 16 16 16 16 16 16 16 16 16 16 16 16 16 16 16 16 16 16 16 16 16 16 16 16 16 16 16 16 16 16 16 16 16 16 16 16 16 16 16 16 16 16 16 16 16 16 16 16 16 16 16 16 16 16 16 16 16 16 16 2 2 2 2 2 2 2