100 20
35 35 26 35 35 35 35 35 35 39 35 35 35 26 35 35 35 35 35 35 35 35 35 35 26 35 35 35 35 35 35 35 35 35 35 35 35 35 35 35 35 35 35 35 35 35 35 35 35 35 35 35 26 35 35 35 35 35 35 35 35 35 35 35 35 35 35 35 35 35 35 35 35 35 35 35 35 35 35 35 35 26 35 35 35 35 35 35 35 35 35 35 35 26 35 35 35 35 35 35
35 35 35 35 35 35 35 35 35 35 35 26 35 35 35 35 35 35 35 35 35 26 35 35 35 35 35 35 35 35 35 35 35 35 35 35 35 35 35 35 35 35 35 35 35 26 35 35 35 35 35 35 35 35 35 26 35 35 35 35 35 35 35 35 35 35 35 26 35 35 35 35 35 35 35 35 35 26 35 35 35 35 35 35 35 35 35 35 35 35 35 35 35 35 35 35 35 35 35 39
26 35 35 35 35 35 35 26 35 35 35 35 26 35 35 35 35 35 35 35 35 35 35 35 35 35 35 35 35 35 35 35 35 35 35 35 26 26 26 26 26 26 35 35 35 35 35 35 35 35 35 35 35 35 35 35 35 35 35 35 35 35 35 35 35 35 35 35 35 35 35 35 35 35 35 35 35 35 35 35 35 35 35 35 26 35 35 35 35 26 35 35 26 35 35 35 26 35 35 35
35 35 35 35 35 35 35 35 35 35 35 35 35 35 35 40 35 35 35 35 35 35 35 35 35 35 35 35 35 35 35 35 26 35 35 35 35 35 35 35 35 35 35 35 35 35 35 35 26 35 35 35 35 35 35 35 35 35 35 35 35 35 35 35 35 35 35 35 35 35 35 26 35 35 35 35 35 35 35 35 35 35 35 35 35 35 35 35 35 35 35 35 35 35 35 35 35 35 35 35
35 35 35 35 35 35 35 35 35 35 35 35 35 35 35 35 35 35 26 35 35 35 35 35 35 35 40 35 35 35 35 35 35 35 35 35 35 35 35 35 35 35 35 35 35 35 35 35 35 35 35 35 35 35 35 35 35 35 26 35 35 35 35 35 35 35 35 35 35 35 35 35 35 35 35 35 35 35 35 35 40 35 35 35 35 35 35 35 35 35 35 35 35 35 40 35 35 35 35 35
35 35 35 35 35 35 35 35 35 35 35 35 35 35 35 35 35 35 35 35 35 35 35 35 35 35 35 35 35 35 35 35 35 35 35 35 35 35 35 35 35 35 35 35 35 35 26 35 35 35 35 26 35 35 35 26 35 35 35 35 35 35 35 35 35 35 35 35 35 35 35 35 35 39 41 41 41 41 41 41 41 41 41 41 35 35 35 35 35 35 35 41 41 41 35 35 35 35 35 35
16 35 26 35 35 35 26 35 35 35 35 35 35 35 35 35 35 35 35 35 35 35 35 39 35 35 35 35 35 35 35 35 35 35 35 35 35 35 26 35 35 35 35 26 35 35 35 35 35 35 35 35 35 35 35 35 35 35 35 35 35 35 35 35 35 35 35 35 26 35 35 35 35 41 41 41 41 41 41 41 41 41 41 41 41 41 26 35 35 41 41 41 41 41 35 35 35 35 35 35
16 35 35 35 35 35 35 35 35 35 35 35 26 35 35 35 35 35 35 35 35 35 35 35 35 35 35 35 35 35 35 35 35 35 35 35 35 35 35 35 35 35 35 35 35 35 35 35 35 35 35 35 35 35 35 35 35 35 35 35 35 35 35 35 35 35 35 35 35 35 35 35 41 41 41 41 41 41 41 41 41 41 41 41 41 41 41 41 41 41 41 41 41 41 35 35 35 35 35 26
16 35 35 35 35 26 35 35 35 35 35 35 35 35 35 35 35 35 35 35 35 26 35 35 35 35 26 35 35 35 35 35 35 35 35 35 35 35 35 35 35 35 35 35 35 35 35 35 26 35 35 35 41 41 41 41 35 26 35 35 35 35 35 35 35 26 35 35 35 35 41 41 41 41 41 41 41 41 41 41 41 41 41 41 41 41 41 41 41 41 41 41 41 41 41 35 35 35 35 35
16 35 35 35 35 35 35 35 35 26 35 35 35 35 35 35 35 35 35 41 35 35 35 35 35 35 35 35 35 35 35 40 35 35 35 35 35 35 35 35 35 35 35 35 35 35 35 35 35 35 35 41 41 41 41 41 35 35 35 35 35 35 35 35 35 35 35 35 35 41 41 41 41 41 41 41 41 41 41 41 41 41 41 41 41 41 41 41 41 41 41 41 41 41 41 41 41 41 41 41
16 35 35 35 35 35 35 35 35 35 35 35 35 35 26 35 35 35 35 41 35 35 35 35 26 35 35 35 35 35 35 35 35 35 35 35 35 35 35 35 35 35 35 35 35 35 35 35 35 35 35 41 41 41 41 41 35 35 39 35 35 26 35 35 35 35 26 35 35 41 41 41 41 41 41 41 41 41 41 41 41 41 41 41 41 41 41 41 41 41 41 41 41 41 41 41 41 41 41 41
16 16 35 35 35 35 35 35 35 35 35 35 35 35 35 35 35 41 41 41 35 35 35 35 35 35 35 26 35 35 35 35 35 35 35 26 35 35 35 35 35 35 35 26 35 35 35 35 35 41 41 41 41 41 41 41 35 35 35 35 35 35 35 35 35 35 35 35 41 41 41 41 41 41 41 41 41 41 41 41 41 41 41 41 41 41 41 41 41 41 41 41 41 41 41 41 41 41 41 41
16 16 41 35 35 35 35 35 35 40 35 35 35 35 35 35 35 41 41 41 41 35 35 35 35 35 35 35 35 35 35 35 35 35 35 35 35 35 35 35 35 35 35 35 35 35 35 26 41 41 41 41 41 41 41 41 35 35 35 35 35 35 35 35 26 35 35 41 41 41 41 41 41 41 41 41 41 41 41 41 41 41 41 41 41 41 41 41 41 41 41 41 41 41 41 41 41 41 41 41
16 16 41 41 41 35 35 35 35 35 35 35 35 35 35 35 41 41 41 41 41 35 35 35 35 35 35 35 35 35 35 35 35 35 35 35 35 41 41 41 26 35 35 35 35 35 35 41 41 41 41 41 41 41 41 41 41 35 35 35 35 35 35 35 35 35 35 41 41 41 41 41 41 41 41 41 41 41 41 41 41 41 41 41 41 41 41 41 41 41 41 41 41 41 41 41 41 41 41 41
16 16 41 41 41 41 35 35 35 35 35 35 35 35 35 41 41 41 41 41 41 41 35 35 26 35 35 35 26 26 35 35 26 35 35 35 41 41 41 41 41 35 35 35 41 41 41 41 41 41 41 41 41 41 41 41 41 35 26 35 35 35 35 35 35 35 41 41 41 41 41 41 41 41 41 41 41 41 41 41 41 41 41 41 41 41 41 41 41 41 41 41 41 41 41 41 41 41 41 41
16 16 41 41 41 41 41 41 35 35 35 35 35 41 41 41 41 41 41 41 41 41 41 35 35 35 35 35 41 41 35 35 35 35 35 41 41 41 41 41 41 41 41 41 41 41 41 41 41 41 41 41 41 41 41 41 41 35 35 35 35 35 35 41 41 41 41 41 41 41 41 41 41 41 41 41 41 41 41 41 41 41 41 41 41 41 41 41 41 41 41 41 41 41 41 41 41 41 41 41
16 16 16 16 41 46 46 46 46 46 46 46 46 46 46 46 46 46 46 46 46 46 46 46 46 46 46 46 46 46 46 46 46 46 46 46 46 46 46 46 46 46 46 46 46 46 46 46 46 46 46 46 46 46 46 46 46 46 46 46 46 46 46 46 46 46 46 46 46 46 46 46 46 46 46 46 46 46 46 46 46 46 46 46 46 46 46 46 46 46 46 46 46 46 46 46 41 41 41 41
16 16 16 16 44 45 45 45 45 45 45 45 45 45 45 45 45 45 45 45 45 45 45 45 45 45 45 45 45 45 45 45 45 45 45 45 45 45 45 45 45 45 45 45 45 45 45 45 45 45 45 45 45 45 45 45 45 45 45 45 45 45 45 45 45 45 45 45 45 45 45 45 45 43 44 45 45 45 45 45 45 45 45 45 45 45 45 45 45 45 45 45 45 45 45 45 43 16 16 16
16 16 16 16 44 30 30 30 30 30 30 30 30 30 30 30 30 30 30 30 30 30 30 30 30 30 30 30 30 30 30 30 30 30 30 30 30 30 30 30 30 30 30 30 30 30 30 30 30 30 30 30 30 30 30 30 30 30 30 30 30 30 30 30 30 30 30 30 30 30 30 30 43 16 16 44 30 30 30 30 30 30 30 30 30 30 30 30 30 30 30 30 30 30 30 30 43 16 16 16
16 16 16 16 16 44 30 30 30 30 30 30 30 30 30 30 30 30 30 30 30 30 30 30 30 30 30 30 30 30 30 30 30 30 30 30 30 30 30 30 30 30 30 30 30 30 30 30 30 30 30 30 30 30 30 30 30 30 30 30 30 30 30 30 30 30 30 30 30 30 30 30 43 16 16 16 44 30 30 30 30 30 30 30 30 30 30 30 30 30 30 30 30 30 30 30 43 16 16 16