50 140
35 35 35 26 35 40 35 35 35 35 35 35 35 35 39 26 35 35 35 35 35 35 35 35 35 35 35 35 35 35 35 35 35 35 26 35 35 35 34 35 35 40 35 35 26 35 35 35 35 35
26 35 35 35 35 35 35 35 35 26 35 35 35 35 35 35 35 35 35 35 35 35 40 26 35 35 35 35 35 35 39 35 35 35 35 35 35 35 35 35 35 35 35 35 35 35 35 35 35 40
35 35 26 35 35 35 26 35 35 35 35 35 35 35 35 35 35 35 35 35 35 35 35 35 35 35 35 35 35 35 35 35 26 35 40 35 35 35 35 35 35 35 35 35 35 35 35 35 35 35
39 35 35 35 35 35 35 35 35 35 35 35 35 35 35 35 35 35 35 26 35 35 35 35 35 35 35 26 26 35 35 35 35 35 35 35 35 26 35 35 26 35 35 35 35 35 35 35 35 35
35 35 26 35 17 17 17 17 35 35 35 40 40 35 35 35 26 35 35 35 35 35 35 26 35 35 35 35 35 35 35 35 26 35 35 35 35 35 35 35 35 35 35 16 17 17 17 17 17 17
35 35 35 17 16 16 16 16 35 35 35 35 35 35 35 35 35 35 26 35 35 35 35 35 35 35 35 35 39 35 35 35 35 35 35 35 35 35 35 35 35 35 35 16 16 16 16 16 16 16
40 35 16 16 16 16 16 16 17 35 35 35 35 35 35 35 35 35 35 35 35 35 35 35 35 35 35 35 35 35 35 35 35 35 35 35 35 35 35 35 35 35 16 16 16 16 16 16 16 16
35 35 16 16 16 16 16 16 16 17 35 35 35 26 35 35 35 35 35 35 35 35 35 35 35 35 35 35 35 35 35 35 35 26 35 39 26 35 35 35 35 17 16 16 16 16 16 16 16 16
35 16 16 16 16 16 16 16 16 16 16 35 35 35 35 35 35 35 35 35 35 39 35 26 35 35 26 35 35 35 26 35 35 35 35 35 35 35 35 35 17 16 16 16 16 16 16 16 16 16
35 16 16 16 16 16 16 16 16 16 16 35 35 35 35 35 26 35 35 35 35 35 35 35 35 35 35 35 35 35 35 35 35 35 35 35 35 35 35 35 16 16 16 16 16 16 16 16 16 16
17 16 16 16 16 16 16 16 16 16 16 16 35 35 35 35 35 35 35 26 35 35 35 35 35 35 35 35 26 35 35 35 35 35 26 35 35 35 35 17 16 16 16 16 16 16 16 16 16 16
16 16 16 16 16 16 26 26 16 16 16 16 16 35 35 35 35 35 35 35 35 35 35 35 40 35 35 35 35 35 40 35 35 35 35 35 35 35 17 16 16 16 16 16 16 16 16 16 16 16
16 16 16 16 16 16 16 16 16 16 16 16 16 17 17 17 35 35 35 35 35 26 35 35 35 35 35 35 35 35 35 35 35 35 35 16 17 17 16 16 16 16 16 16 16 16 16 16 16 16
16 16 16 16 16 16 16 16 16 16 16 16 16 16 16 16 17 17 16 35 35 35 35 35 35 35 35 35 35 35 35 35 17 16 17 16 16 16 16 16 16 16 16 16 16 16 16 16 16 16
16 16 16 16 16 16 16 16 16 16 16 16 16 16 16 16 16 16 16 16 17 17 17 25 25 35 24 25 16 17 17 16 16 16 16 16 16 16 16 16 16 16 16 16 16 16 16 16 16 16
16 16 16 16 16 16 16 16 16 16 16 16 16 16 16 16 16 16 16 16 16 16 16 35 35 35 35 35 16 16 16 16 16 16 16 16 16 16 16 16 16 16 16 16 16 16 16 16 16 16
16 16 16 16 16 16 16 16 16 16 16 16 16 16 16 16 16 16 16 16 16 16 16 35 35 35 35 35 16 16 16 16 16 16 16 16 16 16 16 16 16 16 16 16 16 16 16 16 16 16
16 16 16 16 16 16 16 16 16 16 16 16 16 16 16 16 16 16 16 16 16 16 16 25 35 35 35 25 16 16 16 16 16 16 16 16 16 16 16 16 16 16 16 16 16 16 16 16 16 16
16 16 16 16 16 16 16 16 16 16 16 16 16 16 16 16 16 16 16 35 35 35 35 35 35 35 35 35 35 35 35 35 16 16 16 16 16 16 16 16 16 16 16 16 16 16 16 16 16 16
16 16 16 16 16 16 16 16 16 16 16 16 16 16 16 16 16 16 16 35 35 35 35 35 35 35 35 35 35 35 35 35 16 16 16 16 16 16 16 16 16 16 16 16 16 16 16 16 16 16
16 16 16 16 16 16 16 16 16 16 16 16 16 16 16 16 16 16 16 16 16 16 16 25 35 35 35 25 16 16 16 16 16 16 16 16 16 16 16 16 16 16 16 16 16 16 16 16 16 16
16 16 16 16 16 16 16 16 16 16 16 16 16 16 16 16 16 16 16 16 16 16 16 35 35 35 35 35 16 16 16 16 16 16 16 16 16 16 16 16 16 16 16 16 16 16 16 16 16 16
16 16 16 16 16 16 16 16 16 16 16 16 16 16 16 16 16 16 16 16 35 35 35 35 35 35 35 35 35 35 35 16 16 16 16 16 16 16 16 16 16 16 16 16 16 16 16 16 16 16
16 16 16 16 16 16 16 16 16 16 16 16 16 16 16 16 16 16 16 16 35 35 35 35 35 35 35 35 35 35 35 16 16 16 16 16 16 16 16 16 16 16 16 16 16 16 16 16 16 16
16 16 16 16 16 16 16 16 16 16 16 16 16 16 16 16 16 16 16 16 25 25 25 25 25 25 25 25 25 25 25 16 16 16 16 16 16 16 16 16 16 16 16 16 16 16 16 16 16 16
16 16 16 16 16 16 16 16 16 16 16 16 16 16 16 16 16 16 16 16 35 35 35 35 35 35 35 35 35 35 35 16 16 16 16 16 16 16 16 16 16 16 16 16 16 16 16 16 16 16
16 16 16 16 16 16 16 16 16 16 16 16 16 16 16 16 16 16 16 16 35 35 35 35 35 35 35 35 35 35 35 16 16 16 16 16 16 16 16 16 16 16 16 16 16 16 16 16 16 16
16 16 16 16 16 16 16 16 16 16 16 16 16 16 16 16 16 16 16 16 25 25 25 25 25 25 25 25 25 25 25 16 16 16 16 16 16 16 16 16 16 16 16 16 16 16 16 16 16 16
16 16 16 16 16 16 16 16 16 16 16 16 16 16 16 16 16 16 16 16 35 35 35 35 35 35 35 35 35 35 35 16 16 16 16 16 16 16 16 16 16 16 16 16 16 16 16 16 16 16
16 16 16 16 16 16 16 16 16 16 16 16 16 16 16 16 16 16 16 16 35 35 35 35 35 35 35 35 35 35 35 16 16 16 16 16 16 16 16 16 16 16 16 16 16 16 16 16 16 16
16 16 16 16 16 16 16 16 16 16 16 16 16 16 16 16 16 16 16 16 16 16 16 25 25 25 25 25 16 16 16 16 16 16 16 16 16 16 16 16 16 16 16 16 16 16 16 16 16 16
16 16 16 16 16 16 16 16 16 16 16 16 16 16 16 16 16 16 16 16 16 16 16 35 35 35 35 35 16 16 16 16 16 16 16 16 16 16 16 16 16 16 16 16 16 16 16 16 16 16
16 16 16 16 16 16 16 16 16 16 16 16 16 16 16 16 16 16 16 16 16 16 16 35 35 35 35 35 16 16 16 16 16 16 16 16 16 16 16 16 16 16 16 16 16 16 16 16 16 16
16 16 16 16 16 16 16 16 16 16 16 16 16 16 16 16 16 16 16 16 16 16 16 35 35 35 35 35 16 16 16 16 16 16 16 16 16 16 16 16 16 16 16 16 16 16 16 16 16 16
16 16 16 16 16 16 16 16 16 16 16 16 16 16 16 16 16 16 16 16 16 16 16 25 25 35 35 35 16 16 16 16 16 16 16 16 16 16 16 16 16 16 16 16 16 16 16 16 16 16
16 16 16 16 16 16 16 16 16 16 16 16 16 16 16 16 16 16 16 16 16 16 16 35 35 35 35 35 16 16 16 16 16 16 16 16 16 16 16 16 16 16 16 16 16 16 16 16 16 16
16 16 16 16 16 16 16 16 16 16 16 16 16 16 16 16 16 16 16 16 16 16 16 35 35 35 35 35 16 16 16 16 16 16 16 16 16 16 16 16 16 16 16 16 16 16 16 16 16 16
16 16 16 16 16 16 16 16 16 16 16 16 16 16 16 16 16 16 16 16 16 16 16 35 35 35 35 35 16 16 16 16 16 16 16 16 16 16 16 16 16 16 16 16 16 16 16 16 16 16
16 16 16 16 16 16 16 16 16 16 16 16 16 16 16 16 16 16 16 16 16 16 16 35 35 35 24 25 16 16 16 16 16 16 16 16 16 16 16 16 16 16 16 16 16 16 16 16 16 16
16 16 16 16 16 16 16 16 16 16 16 16 16 16 16 16 35 35 35 35 16 35 35 35 35 35 35 35 16 16 16 16 16 16 16 16 16 16 16 16 16 16 16 16 16 16 16 16 16 16
16 16 16 16 16 16 16 16 35 35 35 16 16 16 16 35 35 35 35 35 35 35 35 35 35 35 35 35 16 16 16 16 16 16 16 16 16 16 16 16 16 16 16 16 16 16 16 16 16 16
35 35 35 16 16 16 35 35 35 35 35 35 16 16 35 35 35 35 35 35 35 35 35 35 35 35 35 35 16 16 16 16 16 16 16 16 16 16 16 16 16 16 16 16 16 16 16 16 16 16
35 35 35 35 35 35 35 35 35 35 35 35 35 35 35 35 35 35 35 35 35 35 35 35 35 35 35 35 16 16 16 16 16 16 16 16 16 16 16 16 16 16 16 16 16 16 16 16 16 16
35 35 35 35 35 35 35 35 35 35 35 35 35 35 35 35 35 35 35 35 35 35 35 35 35 35 35 35 35 35 35 16 16 16 16 16 16 16 16 16 16 16 16 16 16 16 16 16 16 16
35 35 35 35 35 35 35 35 35 35 35 35 35 35 35 35 35 35 35 35 35 35 35 35 35 35 35 35 35 35 35 16 16 16 16 16 16 16 16 16 16 16 16 16 16 16 16 16 16 16
16 35 35 35 35 35 35 35 35 35 35 35 35 35 35 35 16 35 35 35 35 35 35 35 35 35 35 35 35 35 35 35 35 35 16 16 16 16 16 16 16 16 16 16 16 16 16 16 16 16
16 16 28 28 28 16 28 28 28 16 28 28 28 16 28 28 16 16 35 35 35 35 35 35 35 35 35 35 35 35 35 35 35 35 35 35 16 16 16 16 16 16 16 16 16 16 16 16 16 16
16 30 30 30 30 30 30 30 30 30 30 30 30 30 30 30 16 16 16 16 16 16 16 25 35 35 35 35 16 16 16 16 16 35 35 35 35 35 35 35 16 16 16 16 16 16 16 16 16 16
30 30 30 30 30 30 30 30 30 30 30 30 30 30 30 16 16 16 16 16 16 16 16 35 35 35 35 35 16 16 16 16 16 16 16 35 35 35 35 35 35 35 16 16 16 16 16 16 16 16
30 30 30 30 30 30 30 30 30 30 30 30 30 30 30 16 16 16 16 16 16 16 16 35 35 35 35 35 16 16 16 16 16 16 16 16 16 35 35 35 35 35 16 16 16 16 16 16 16 16
30 30 30 30 30 30 30 30 30 30 30 30 16 16 16 16 16 16 16 16 16 16 16 35 35 35 35 35 16 16 16 16 16 16 16 16 16 16 35 35 35 35 35 16 16 16 16 16 16 16
16 16 16 16 16 16 16 16 16 16 16 16 16 16 16 16 16 16 16 16 16 16 16 35 35 35 35 35 16 16 16 16 16 16 16 35 35 35 35 35 35 35 35 35 35 16 16 16 16 16
16 16 16 16 16 16 16 16 16 16 16 16 16 16 16 16 16 16 16 16 16 16 16 35 35 35 35 35 16 16 16 16 16 16 16 35 35 35 35 35 35 35 35 35 35 35 35 35 35 16
16 16 16 16 16 16 16 16 16 16 16 16 16 16 16 16 16 16 16 16 16 16 16 35 35 35 35 35 16 16 16 16 16 16 16 16 16 16 16 16 16 35 35 35 35 35 35 35 35 35
16 16 16 16 16 16 16 16 16 16 16 16 16 16 16 16 16 16 16 16 16 16 16 35 35 35 35 35 16 16 16 16 16 16 16 16 16 16 16 16 16 35 35 35 35 35 35 35 35 35
16 16 16 16 16 16 16 16 16 16 16 16 16 16 16 16 16 16 16 16 16 16 16 35 35 35 35 35 16 16 16 16 16 16 16 16 16 16 35 35 35 35 35 16 28 28 28 28 28 28
16 16 16 16 16 16 16 16 16 16 16 16 16 16 16 16 16 16 16 16 16 16 16 35 35 35 35 35 16 35 35 35 35 35 35 35 35 35 35 35 35 35 16 16 30 30 30 30 30 30
16 16 16 16 16 16 16 16 16 16 16 16 16 16 16 16 16 16 16 16 16 16 16 35 35 35 35 35 35 35 35 35 35 35 35 35 35 35 35 16 16 16 16 16 30 30 30 30 30 30
16 16 16 16 16 16 16 16 16 16 16 16 16 16 16 16 16 16 16 16 16 16 16 35 35 35 35 35 35 35 35 35 35 35 35 35 35 35 16 16 16 16 16 30 30 30 30 30 30 30
16 16 16 16 16 16 16 16 16 16 16 16 16 16 16 16 16 16 16 16 16 16 16 25 35 35 35 35 16 16 16 16 16 16 16 16 16 16 16 16 16 16 16 30 30 30 30 30 30 30
16 16 16 16 16 16 16 16 16 16 16 16 16 16 16 16 16 16 16 16 16 16 16 35 35 35 35 35 16 16 16 16 16 16 16 16 16 16 16 16 16 16 30 30 30 30 30 30 30 30
16 16 16 16 16 16 16 16 16 16 16 16 16 16 16 16 16 16 16 16 16 16 16 35 35 35 35 35 16 16 16 16 16 16 16 16 16 16 16 16 16 16 30 30 30 30 30 30 30 30
16 16 16 16 16 16 16 16 16 16 16 16 16 16 16 16 16 16 16 16 16 16 16 35 35 35 24 25 16 16 16 16 16 16 16 16 16 16 16 16 16 16 16 16 30 30 30 30 30 30
16 16 16 16 16 16 16 16 16 16 16 16 16 16 16 16 16 16 16 16 16 16 16 35 35 35 35 35 16 16 16 16 16 16 16 16 16 16 16 16 16 16 16 16 30 30 30 30 30 30
16 16 16 16 16 16 16 16 16 16 16 16 16 16 16 16 16 16 16 16 16 16 16 35 35 35 35 35 16 16 16 16 16 16 16 16 16 16 16 16 16 16 16 16 16 16 30 30 30 30
16 16 16 16 16 16 16 16 16 16 16 16 16 16 16 16 16 16 16 35 35 35 35 35 35 35 35 35 35 35 35 35 16 16 16 16 16 16 16 16 16 16 16 16 16 16 16 16 16 16
16 16 16 16 16 16 16 16 16 16 16 16 16 16 16 16 16 16 16 35 35 35 35 35 35 35 35 35 35 35 35 35 16 16 16 16 16 16 16 16 16 16 16 16 16 16 16 16 16 16
16 16 16 16 16 16 16 16 16 16 16 16 16 16 16 16 16 16 16 16 16 16 16 35 35 35 35 35 16 16 16 16 16 16 16 16 16 16 16 16 16 16 16 16 16 16 16 16 16 16
16 16 16 16 16 16 16 16 16 16 16 16 16 16 16 16 16 16 16 16 16 16 16 25 25 25 25 25 16 16 16 16 16 16 16 16 16 16 16 16 16 16 16 16 16 16 16 16 16 16
16 16 16 16 16 16 16 16 16 16 16 16 16 16 16 16 16 16 16 16 16 16 35 35 35 35 35 35 16 16 16 16 16 16 16 16 16 16 16 16 16 16 16 16 16 16 16 16 16 16
16 16 16 16 16 16 16 16 16 16 16 16 16 16 16 16 16 16 16 16 35 35 35 35 35 35 35 35 35 35 35 16 16 16 16 35 35 35 35 16 16 16 16 16 16 16 16 16 16 16
16 16 16 16 16 16 16 16 16 16 16 16 16 16 28 28 28 28 28 28 28 28 16 35 35 35 35 35 35 35 35 35 35 35 35 35 35 35 35 35 35 35 35 16 16 16 16 16 16 16
16 16 16 16 16 16 16 16 16 16 16 16 16 16 30 30 30 30 30 30 30 30 16 35 35 35 24 16 16 16 16 16 28 28 28 28 28 28 28 28 28 28 28 28 16 16 16 16 16 16
16 16 16 16 16 16 16 16 16 16 16 16 16 16 30 30 30 30 30 30 30 30 16 35 35 35 35 16 16 16 16 16 16 30 30 30 30 30 30 30 30 30 30 30 30 30 30 16 16 16
16 16 16 16 16 16 16 16 16 16 16 16 16 16 30 30 30 30 30 30 30 30 16 35 35 35 35 35 16 16 16 16 16 16 30 30 30 30 30 30 30 30 30 30 30 30 30 30 16 16
16 16 16 16 16 16 16 16 16 16 16 16 16 16 30 30 30 30 30 30 30 30 16 16 35 35 35 35 16 16 16 16 16 16 16 16 16 16 30 30 30 30 30 30 30 30 30 30 16 16
16 16 16 16 16 16 16 16 16 16 16 16 16 16 30 30 30 30 30 30 30 16 16 35 35 35 35 35 16 16 16 16 16 16 16 16 16 16 30 30 30 30 30 30 30 30 30 30 16 16
16 16 16 16 16 16 16 16 16 16 16 16 16 16 30 30 30 30 30 30 30 16 16 35 35 35 35 35 16 16 16 16 16 16 16 16 16 16 16 16 30 30 30 30 30 30 30 30 16 16
16 16 16 16 16 16 16 16 16 16 16 16 16 16 16 16 16 16 16 16 16 16 16 35 25 25 25 35 16 16 16 16 16 16 16 16 16 16 16 16 16 16 16 30 30 30 30 16 16 16
16 16 16 16 16 16 16 16 16 16 16 16 16 16 16 16 16 16 16 16 16 16 16 35 35 35 35 35 16 16 16 16 16 16 16 16 16 16 16 16 16 16 16 16 16 16 16 16 16 16
16 16 16 16 16 16 16 16 16 16 16 16 16 16 16 16 16 16 16 16 16 16 16 35 35 35 35 35 16 16 16 16 16 16 16 16 16 16 16 16 16 16 16 16 16 16 16 16 16 16
16 16 16 16 16 16 16 16 16 16 16 16 16 16 16 16 16 16 16 16 16 16 16 25 35 35 35 24 16 16 16 16 16 16 16 16 16 16 16 16 16 16 16 16 16 16 16 16 16 16
16 16 16 16 16 16 16 16 16 16 16 16 16 16 16 16 16 16 16 16 16 16 35 35 35 35 35 35 35 16 16 16 16 16 16 16 16 16 16 16 16 16 16 16 16 16 16 16 16 16
16 16 16 16 16 16 16 16 16 16 16 16 16 16 16 16 16 16 16 16 16 35 35 35 35 35 35 35 35 35 16 16 16 16 16 16 16 16 16 16 16 16 16 16 16 16 16 16 16 16
16 16 16 16 16 16 16 16 16 16 16 16 16 16 16 16 16 16 16 16 35 35 35 35 35 35 35 35 35 35 35 16 16 16 16 16 16 16 16 16 16 16 16 16 16 16 16 16 16 16
16 16 16 16 16 16 16 16 16 16 16 16 16 16 16 16 16 16 16 35 35 35 35 35 35 35 35 35 35 35 35 35 16 16 16 16 16 16 16 16 16 16 16 16 16 16 16 16 16 16
16 16 16 16 16 16 16 16 16 16 16 16 16 16 16 16 16 16 35 35 35 35 35 35 35 35 35 35 35 35 35 35 16 16 16 16 16 16 16 16 16 16 16 16 16 16 16 16 16 16
16 16 16 16 16 16 16 16 16 16 16 16 16 16 35 35 35 35 35 35 35 35 35 35 35 35 35 35 35 35 35 35 16 16 16 16 16 16 16 16 16 16 16 16 16 16 16 16 16 16
16 16 16 16 16 16 16 16 16 35 35 35 35 35 35 35 35 35 35 35 35 35 35 35 35 35 35 35 35 35 35 35 16 16 16 16 16 16 16 16 16 16 16 16 16 16 16 16 16 16
16 16 16 16 16 16 16 16 16 35 35 35 35 35 35 35 35 35 35 35 35 35 35 35 35 35 35 35 35 35 35 35 35 16 16 16 16 16 16 16 16 16 16 16 16 16 16 16 16 16
16 16 16 16 16 16 16 16 16 16 28 28 28 28 28 28 28 16 16 35 35 35 35 35 35 35 35 35 35 35 35 35 35 35 35 16 16 16 16 16 16 16 16 16 16 16 16 16 16 16
16 16 16 16 16 16 16 16 16 16 30 30 30 30 30 30 30 16 16 35 35 35 35 35 35 35 35 35 35 35 35 35 35 35 35 35 35 16 16 16 16 16 16 16 16 16 16 16 16 16
16 16 16 16 16 16 16 16 16 16 16 30 30 30 30 16 16 16 16 35 35 35 35 35 35 35 35 35 35 35 35 35 35 35 35 35 35 35 16 16 16 16 16 16 35 35 35 35 35 16
16 16 16 16 16 16 16 16 16 16 16 16 16 16 16 16 16 16 16 35 35 35 35 35 35 35 35 35 35 35 35 35 35 35 35 35 35 35 35 16 16 16 35 35 35 35 35 35 35 35
16 16 16 16 16 16 16 16 16 16 16 16 16 16 16 16 16 16 16 35 35 35 35 35 35 35 35 35 35 35 35 35 35 35 35 35 35 35 35 35 35 35 35 35 35 35 35 35 35 35
16 16 16 16 16 16 16 16 16 16 16 16 16 16 16 16 16 16 16 16 35 35 35 35 35 35 35 35 35 35 35 16 28 28 28 28 28 28 28 28 28 28 28 28 28 28 28 28 28 16
16 16 16 16 16 16 16 16 16 16 16 16 16 16 16 16 16 16 16 16 16 35 35 35 35 35 35 35 35 35 16 16 30 30 30 30 30 30 30 30 30 30 30 30 30 30 30 30 30 16
16 16 16 16 16 16 16 16 16 16 16 16 16 16 16 16 16 16 16 16 16 16 35 35 35 35 35 35 35 16 16 16 16 16 30 30 30 30 30 30 30 30 30 30 30 30 30 30 30 16
16 16 16 16 16 16 16 16 16 16 16 16 16 16 16 16 16 16 16 16 16 16 16 35 35 35 24 25 16 16 16 16 16 16 16 16 16 16 30 30 30 30 30 30 30 30 30 30 30 16
16 16 16 16 16 16 16 16 16 16 16 16 16 16 16 16 16 16 16 16 16 16 16 35 35 35 35 35 16 16 16 16 16 16 16 16 16 16 16 16 16 30 30 30 30 30 30 30 16 16
16 16 16 16 16 16 16 16 16 16 16 16 16 16 16 16 16 16 16 16 16 16 16 35 35 35 35 35 16 16 16 16 16 16 16 16 16 16 16 16 16 16 16 16 16 16 16 16 16 16
16 16 16 16 16 16 16 16 16 16 16 16 16 16 16 16 16 16 16 16 16 16 16 35 35 35 35 35 16 16 16 16 16 16 16 16 16 16 16 16 16 16 16 16 16 16 16 16 16 16
16 16 16 16 16 16 16 16 16 16 16 16 16 16 16 16 16 16 16 16 16 16 16 25 25 35 35 35 35 16 16 16 16 16 16 16 16 16 16 16 16 16 16 16 16 16 16 16 16 16
16 16 16 16 16 16 16 16 16 16 16 16 16 16 16 16 16 16 16 16 16 16 16 35 35 35 35 35 35 35 35 35 35 16 16 16 16 16 16 16 16 16 16 16 16 16 16 16 16 16
16 16 16 16 16 16 16 16 16 16 16 16 16 16 16 16 16 16 16 16 16 16 16 35 35 35 35 35 35 35 35 35 35 35 35 16 16 16 16 16 16 16 16 16 16 16 16 16 16 16
16 16 16 16 16 16 16 16 16 16 16 16 16 16 16 16 16 16 16 16 16 16 16 35 35 35 35 35 35 35 35 35 35 35 35 16 16 16 16 16 16 16 16 16 16 16 16 16 16 16
16 16 16 16 16 16 16 16 16 16 16 16 16 16 16 16 16 16 16 16 16 16 16 35 35 35 35 35 35 35 35 35 35 35 35 35 16 16 16 16 16 16 16 16 16 16 16 16 16 16
16 16 16 16 16 16 16 16 16 16 16 16 16 16 16 16 16 16 16 16 16 16 16 35 35 35 35 35 35 35 35 35 35 35 24 25 16 16 16 16 16 16 16 16 16 16 16 16 16 16
16 16 16 16 16 16 16 16 16 16 16 16 16 16 16 16 16 16 16 16 16 16 16 35 35 35 35 35 35 35 35 35 35 35 35 35 35 35 16 16 16 16 16 16 16 16 16 16 16 16
16 16 16 16 16 16 16 16 16 16 16 16 16 16 16 16 16 16 16 16 16 16 16 35 35 35 35 35 35 35 35 35 35 35 35 35 35 35 16 16 16 16 16 16 16 16 16 16 16 16
16 16 16 16 16 16 16 16 16 16 16 16 16 16 16 16 16 16 16 16 16 16 16 25 25 25 25 25 16 16 16 16 16 16 16 16 16 16 16 16 16 16 16 16 16 16 16 16 16 16
16 16 16 16 16 16 16 16 16 16 16 16 16 16 16 16 16 16 16 16 16 16 16 35 35 35 35 35 16 16 16 16 16 16 16 16 16 16 16 16 16 16 16 16 16 16 16 16 16 16
16 16 16 16 16 16 16 16 16 16 16 16 16 16 16 16 16 16 16 16 16 16 16 35 35 35 35 35 16 16 16 16 16 16 16 16 16 16 16 16 16 16 16 35 35 35 35 35 16 16
16 16 16 16 16 16 16 16 16 16 16 16 16 16 16 16 16 16 16 16 16 16 16 35 35 35 35 35 16 16 16 16 16 16 16 16 35 35 35 35 35 35 35 35 35 35 35 35 16 16
16 16 16 16 16 16 16 16 16 16 16 16 16 16 16 16 16 16 16 16 16 16 16 35 35 35 24 25 16 16 16 16 35 35 35 35 35 35 35 35 35 35 35 35 35 35 35 16 16 16
16 16 16 16 16 16 16 16 16 16 16 16 16 16 16 16 16 16 16 16 16 16 16 35 35 35 35 35 16 16 16 28 28 28 28 28 28 28 28 28 28 28 28 28 28 28 16 16 16 16
16 16 16 16 16 16 16 16 16 16 16 16 16 16 16 16 16 16 16 16 16 35 35 35 35 35 35 35 16 16 16 30 30 30 30 30 30 30 30 30 30 30 30 30 30 30 16 16 16 16
16 16 16 16 16 16 16 16 16 16 16 16 16 16 16 35 35 35 35 35 35 35 35 35 35 35 35 24 16 16 16 30 30 30 30 30 30 30 30 30 30 30 30 30 30 30 16 16 16 16
16 16 16 16 16 16 16 16 16 16 16 16 16 35 35 35 35 35 35 35 35 35 35 35 35 35 35 35 16 16 16 30 30 30 30 30 30 30 30 30 30 30 30 30 30 30 16 16 16 16
16 16 16 16 16 16 16 16 35 35 35 35 35 35 35 35 35 35 35 35 35 35 35 35 35 35 35 35 16 16 16 30 30 30 30 30 30 30 30 30 30 30 30 30 30 16 16 16 16 16
16 16 16 16 16 28 28 28 28 28 28 28 28 28 16 35 35 35 35 35 35 35 35 35 35 35 35 35 16 16 16 16 16 16 16 16 16 30 30 30 30 30 30 30 16 16 16 16 16 16
16 16 16 30 30 30 30 30 30 30 30 30 30 30 16 35 35 35 35 35 35 35 35 35 35 35 35 35 16 16 16 16 16 16 16 16 16 16 16 16 16 16 16 16 16 16 16 16 16 16
16 16 16 30 30 30 30 30 30 30 30 30 30 30 16 16 35 35 35 35 35 35 35 35 35 35 35 35 16 16 16 16 16 16 16 16 16 16 16 16 16 16 16 16 16 16 16 16 16 16
16 16 16 30 30 30 30 30 30 30 30 30 16 16 16 16 16 16 16 16 16 16 16 25 35 35 35 35 16 16 16 16 16 16 16 16 16 16 16 16 16 16 16 16 16 16 16 16 16 16
16 16 16 30 30 30 30 30 30 30 30 16 16 16 16 16 16 16 16 16 16 16 16 35 35 35 24 25 16 16 16 16 16 16 16 16 16 16 16 16 16 16 16 16 16 16 16 16 16 16
16 16 16 16 16 16 16 16 16 16 16 16 16 16 16 16 16 16 16 16 16 16 16 35 35 35 35 35 16 16 16 16 16 16 16 16 16 16 16 16 16 16 16 16 16 16 16 16 16 16
16 16 16 16 16 16 16 16 16 16 16 16 16 16 16 16 16 16 16 16 16 16 16 35 35 35 35 35 16 35 35 35 35 16 16 16 16 16 16 16 16 16 16 16 16 16 16 16 16 16
16 16 16 16 16 16 16 16 16 16 16 16 16 16 16 16 16 16 16 16 16 16 16 25 35 35 35 35 35 35 35 35 35 35 35 35 16 16 16 16 16 16 16 16 16 16 16 16 16 16
16 16 16 16 16 16 16 16 16 16 16 16 16 16 16 16 16 16 16 16 16 16 16 35 35 35 35 35 16 16 16 16 16 35 35 35 35 35 16 16 16 16 16 16 16 16 16 16 16 16
16 16 16 16 16 16 16 16 16 16 16 16 16 16 16 16 16 16 16 16 16 16 16 35 35 35 35 35 16 16 16 16 16 16 16 16 16 35 35 16 16 16 16 16 16 16 16 16 16 16
16 16 16 16 16 16 16 16 16 16 16 16 16 16 16 16 16 16 16 16 16 16 16 25 25 25 25 25 16 16 16 16 16 16 16 16 16 16 35 35 35 35 35 16 16 16 16 16 16 16
16 16 16 16 16 16 16 16 16 16 16 16 16 16 16 16 16 16 16 16 16 16 35 35 35 35 35 35 35 16 16 16 16 16 16 16 16 16 16 35 35 35 35 35 16 16 16 16 16 16
16 16 16 16 16 16 16 16 16 16 16 16 16 16 16 16 16 16 16 16 16 35 35 35 35 35 35 35 35 35 16 16 16 16 16 16 16 16 16 16 16 16 16 35 35 16 16 16 16 16
16 16 16 16 16 16 16 16 16 16 16 16 16 16 16 16 16 16 16 16 35 35 35 35 35 35 35 35 35 35 35 16 16 16 16 16 16 16 16 16 16 16 16 16 35 35 16 16 16 16
7 35 35 35 35 35 35 35 35 35 35 35 35 35 35 35 35 35 35 35 35 35 35 35 35 35 35 35 35 35 35 35 35 35 35 35 35 35 35 35 35 35 35 35 35 35 35 2 2 2
7 35 35 35 35 35 35 35 35 35 35 35 35 35 35 35 35 35 35 35 35 35 35 35 35 35 35 35 35 35 35 35 35 35 35 35 35 35 35 35 35 35 35 2 2 2 2 2 2 2
7 35 35 35 35 35 35 35 35 35 35 35 35 35 35 35 35 35 35 35 35 35 35 35 35 35 35 35 35 35 35 35 35 35 35 35 35 35 35 35 35 2 2 2 2 2 2 2 2 2
16 16 16 16 16 16 16 16 16 16 16 16 16 16 16 16 16 16 16 16 35 35 35 35 35 35 35 35 35 35 35 16 16 16 16 16 16 16 2 2 16 16 16 16 16 16 16 16 16 16
16 16 16 16 16 16 16 16 16 16 16 16 16 16 16 16 16 16 16 16 25 25 25 25 25 25 25 25 25 25 25 16 16 16 16 16 16 16 16 16 16 16 16 16 16 16 16 16 16 16
28 28 28 28 28 28 28 28 28 28 28 28 28 28 28 28 28 28 28 28 28 28 28 28 28 28 28 28 28 28 28 28 28 28 28 28 28 28 28 28 28 28 28 28 28 28 28 28 28 28