150 30
35 35 35 35 35 35 35 35 35 35 35 35 35 35 35 35 35 35 35 35 35 35 35 35 35 35 35 35 35 35 35 35 35 35 35 35 35 35 35 35 35 35 35 35 35 35 35 35 35 35 35 35 35 35 35 35 35 35 35 35 35 35 35 35 35 35 35 35 35 35 35 35 35 35 35 35 35 35 35 35 35 35 35 35 35 35 35 35 35 35 35 35 35 35 35 35 35 35 35 35 35 35 35 35 35 35 35 35 35 35 35 35 35 35 35 35 35 35 35 35 35 35 35 35 35 35 35 35 35 35 35 35 35 35 35 35 35 35 35 35 35 35 35 35 35 35 35 35 35 35
35 35 35 35 35 35 35 35 35 35 35 35 35 35 35 35 35 35 35 35 35 35 35 35 35 35 35 35 35 35 35 35 35 35 35 35 35 35 35 35 35 35 35 35 35 35 35 35 35 35 35 35 35 35 35 35 35 35 35 35 35 35 35 35 35 35 35 35 35 35 35 35 35 35 35 35 35 35 35 35 35 35 35 35 35 35 35 35 35 35 35 35 35 35 35 35 35 35 35 35 35 35 35 35 35 35 35 35 35 35 35 35 35 35 35 35 35 35 35 35 35 35 35 35 35 35 35 35 35 35 35 35 35 35 35 35 35 35 35 35 35 35 35 35 35 35 35 35 35 35
35 35 35 35 35 35 35 35 35 35 35 35 35 35 35 35 35 35 35 35 35 35 35 35 35 35 35 35 35 35 35 35 35 35 35 35 35 35 35 35 35 35 35 35 35 35 35 35 35 35 35 35 35 35 35 35 35 35 35 35 35 35 35 35 35 35 35 35 35 35 35 35 35 35 35 35 35 35 35 35 35 35 35 35 35 35 35 35 35 35 35 35 35 35 35 35 35 35 35 35 35 35 35 35 35 35 35 35 35 35 35 35 35 35 35 35 35 35 35 35 35 35 35 35 35 35 35 35 35 35 35 35 35 35 35 35 35 35 35 35 35 35 35 35 35 35 35 35 35 35
35 35 35 35 35 35 35 35 35 35 35 35 35 35 35 35 35 35 35 35 35 35 35 35 35 35 35 35 35 35 35 35 35 35 35 35 35 35 35 35 35 35 35 35 35 35 35 35 35 35 35 35 35 35 35 35 35 35 35 35 35 35 35 35 35 35 35 35 35 35 35 35 35 35 35 35 35 35 35 35 35 35 35 35 35 35 35 35 35 26 35 35 35 35 35 35 35 35 35 35 35 35 35 35 35 35 35 35 35 35 35 35 35 35 35 35 35 35 35 35 35 35 35 35 35 35 35 35 35 35 35 35 35 35 35 35 35 35 35 35 35 35 35 35 35 35 35 35 35 35
35 35 35 35 35 35 35 35 35 35 35 35 35 35 35 35 35 35 35 35 35 35 35 35 35 35 35 35 35 35 35 35 35 35 35 35 35 35 35 35 35 35 35 35 35 35 35 35 35 35 35 35 35 35 35 35 35 35 35 35 35 35 35 35 35 35 35 35 35 35 35 35 35 35 35 35 35 35 35 35 35 35 35 35 35 35 35 35 35 35 35 35 35 35 26 35 35 35 35 35 26 35 35 35 35 35 35 35 35 35 35 35 35 35 35 35 35 35 35 35 35 35 35 35 35 35 35 35 35 35 35 35 35 35 35 35 35 35 35 35 35 35 35 35 35 35 35 35 35 35
35 35 35 35 35 35 35 35 35 35 35 35 35 35 35 35 35 35 35 35 35 35 35 35 35 35 35 35 35 35 35 35 35 35 35 35 35 35 35 35 35 35 35 35 35 35 35 35 35 35 35 35 35 35 35 35 35 35 35 35 35 35 35 35 35 35 35 35 35 35 35 35 35 35 35 35 35 35 35 35 35 35 35 35 35 35 35 35 35 35 35 35 35 35 35 35 35 35 35 35 35 35 35 35 35 35 35 35 35 35 35 35 35 35 35 35 35 35 35 35 35 35 35 35 35 35 35 35 35 35 35 35 35 35 35 35 35 35 35 35 35 35 35 35 35 35 35 35 35 35
35 35 35 35 35 35 35 35 35 35 35 35 35 35 35 35 35 35 35 35 35 35 35 35 35 35 35 35 35 35 35 35 35 35 35 35 35 35 35 35 35 35 35 35 35 35 35 35 35 35 35 35 35 35 35 35 35 35 35 35 35 35 35 35 35 35 35 35 35 35 35 35 35 35 35 35 35 35 35 35 35 35 35 35 35 35 35 35 35 35 35 35 35 35 35 35 35 39 35 35 35 35 35 35 35 35 40 35 35 35 35 35 35 35 35 35 35 35 35 35 35 35 35 35 35 26 35 35 35 35 35 35 35 26 35 35 35 35 35 26 35 26 35 35 35 35 35 35 35 35
35 35 35 35 35 35 35 35 35 35 35 35 35 35 35 35 35 35 35 35 35 35 35 35 35 35 35 35 35 35 35 35 35 35 35 35 35 35 35 35 35 35 35 35 35 35 35 35 35 35 35 35 35 35 35 35 35 35 35 35 35 35 35 35 35 35 35 35 35 35 35 35 35 35 35 35 35 35 35 35 35 35 35 35 35 35 35 35 35 35 26 35 35 35 35 26 35 35 35 35 35 26 35 35 35 35 35 35 35 35 35 35 35 35 35 35 35 35 35 35 35 35 26 35 35 35 35 35 35 26 35 35 35 35 35 35 35 35 35 35 35 35 35 35 35 35 35 35 26 35
35 35 35 35 35 35 35 35 35 35 35 35 35 35 35 35 35 35 35 35 35 35 35 35 35 35 35 35 35 35 35 35 35 35 35 35 35 35 35 35 35 35 35 35 35 35 35 35 35 35 35 35 35 35 35 35 35 35 35 35 35 35 35 35 35 35 35 35 35 35 35 35 35 35 35 35 35 35 35 35 35 35 35 35 35 35 26 35 35 35 35 26 35 35 35 35 35 35 35 35 35 35 35 26 35 35 35 26 35 35 35 35 35 35 35 35 35 35 35 26 35 35 35 26 35 35 35 35 35 35 35 26 35 35 26 26 35 35 35 35 35 26 35 35 35 26 35 35 35 35
35 35 35 35 35 35 35 35 35 35 35 35 35 35 35 35 35 35 35 35 35 35 35 35 35 35 35 35 35 35 35 35 35 35 35 35 35 35 35 35 35 35 35 35 35 35 35 35 35 35 35 35 35 35 35 35 35 35 35 35 35 35 35 35 35 35 35 35 35 35 35 35 35 35 35 35 35 35 35 35 35 35 35 35 35 35 35 35 35 35 26 35 35 35 35 35 35 35 35 26 35 35 35 35 35 35 35 35 35 35 35 35 35 35 35 35 35 35 35 35 35 35 35 35 35 35 35 35 35 35 35 35 35 35 35 35 35 35 40 35 35 35 35 35 35 35 35 35 35 35
35 35 35 35 35 35 35 35 35 35 35 35 35 35 35 35 35 35 35 35 35 35 35 35 35 35 35 35 35 35 35 35 35 35 35 35 35 35 35 35 35 35 35 35 35 35 35 35 35 35 35 35 35 35 35 35 35 35 35 35 35 35 35 35 35 35 35 26 35 35 35 35 35 35 35 35 35 35 35 35 35 35 35 35 35 35 35 35 26 35 35 35 35 26 35 35 26 35 35 35 35 35 35 26 35 35 35 26 35 35 35 35 35 35 35 35 35 35 35 35 35 26 35 35 35 39 35 35 35 35 26 35 26 35 35 35 35 35 35 35 35 35 35 35 35 35 35 26 35 35
35 35 35 35 35 35 35 35 35 35 35 35 35 35 35 35 35 35 35 35 35 35 35 35 35 35 35 35 35 35 35 35 35 35 35 35 35 35 35 35 35 35 35 35 35 35 35 35 35 35 35 35 35 35 35 35 35 35 35 35 35 35 26 35 35 35 35 35 35 26 35 35 26 35 35 35 35 35 35 35 35 26 35 35 35 35 35 35 35 35 35 35 35 35 35 35 35 35 26 35 8 8 8 8 8 35 35 35 35 35 35 26 35 35 35 35 35 35 35 35 35 35 35 35 35 35 35 35 26 35 35 35 35 35 35 35 35 35 35 35 35 26 35 26 35 35 35 35 35 26
35 35 35 35 35 35 35 35 35 35 35 35 35 35 35 35 35 35 35 35 35 35 35 35 35 35 35 35 35 35 35 35 35 35 35 35 35 35 35 35 35 35 35 35 35 35 35 35 35 35 35 35 35 35 35 35 35 35 35 35 35 35 35 35 35 35 35 35 35 35 35 35 35 35 35 35 26 35 35 35 35 35 35 35 35 26 35 26 35 35 35 26 35 35 35 35 35 35 35 8 8 8 8 8 8 8 35 35 35 26 35 26 35 35 26 35 35 35 26 35 35 35 35 35 35 26 35 35 35 35 35 35 26 35 35 35 26 35 26 35 35 35 35 35 35 35 35 35 35 35
35 35 35 35 35 35 35 35 35 35 35 35 35 35 35 35 35 35 35 35 35 35 35 35 35 35 35 35 35 35 35 35 35 35 35 35 35 35 35 35 35 35 35 35 35 35 35 35 35 35 35 35 35 35 35 35 35 35 35 26 35 35 35 35 26 26 35 35 35 26 35 35 35 35 35 35 35 35 35 26 35 35 35 35 35 35 35 35 35 35 35 35 35 35 35 35 35 35 8 8 8 8 8 8 8 8 8 35 35 35 35 35 35 35 35 35 35 35 35 35 26 35 35 35 35 35 35 26 35 35 35 35 35 39 35 35 35 35 35 35 35 35 35 35 35 35 35 39 35 35
35 35 35 35 35 35 35 35 35 35 35 35 35 35 35 35 35 35 35 35 35 35 35 35 35 35 35 35 35 35 35 35 35 35 35 35 35 35 35 35 35 35 35 35 35 35 35 35 35 35 26 35 35 35 35 35 35 35 35 35 35 35 26 35 35 35 35 35 35 35 35 26 35 35 35 26 35 35 35 35 35 35 35 26 35 35 35 35 35 35 35 35 35 35 35 26 35 35 8 8 8 8 8 8 8 8 8 35 35 35 35 35 26 35 35 35 35 35 35 35 35 35 35 35 35 26 35 35 35 26 35 35 35 35 35 35 35 35 35 26 35 40 35 35 26 35 35 35 35 35
35 35 35 35 35 35 35 35 35 35 35 35 35 35 35 35 35 35 35 35 35 35 35 35 35 35 35 35 35 35 35 35 35 35 26 35 35 35 35 35 26 35 26 35 35 35 26 35 35 35 35 35 35 35 35 35 35 35 35 35 35 35 35 35 35 35 35 35 35 35 35 35 35 35 35 35 35 35 35 35 35 35 35 35 26 35 26 26 35 35 35 26 35 35 35 35 35 35 40 8 8 8 8 8 8 8 39 35 35 35 35 35 35 35 35 35 26 35 26 35 35 35 35 35 35 35 35 35 35 35 35 35 26 35 35 35 35 35 16 35 35 35 35 35 35 35 35 35 35 26
35 35 35 35 35 35 35 35 35 35 35 35 35 35 35 35 35 35 35 35 35 35 35 35 35 35 35 35 35 35 26 35 26 35 35 35 35 35 35 35 35 35 35 35 35 35 35 35 35 35 35 35 35 26 35 35 35 26 35 35 35 26 35 35 26 35 35 35 26 35 35 35 35 40 35 35 35 26 35 35 26 35 35 35 35 35 35 35 26 35 35 26 35 35 35 35 35 35 35 35 35 8 12 8 35 35 35 35 35 26 35 26 35 35 35 35 35 35 35 35 35 35 26 35 35 16 16 16 16 16 16 16 35 35 26 35 35 35 16 16 35 35 35 35 35 35 35 26 35 35
35 35 35 35 35 35 35 35 35 35 35 35 35 35 35 35 35 35 35 35 35 35 35 35 35 35 35 35 35 35 35 35 35 35 35 26 35 35 35 35 26 35 26 35 35 35 35 35 35 35 26 35 35 35 35 35 35 35 35 35 26 35 35 35 35 35 35 35 35 35 26 35 35 35 35 35 35 35 35 35 35 26 35 26 35 35 35 35 35 35 35 35 35 35 35 35 26 35 35 26 35 35 13 35 35 35 35 35 35 35 35 35 35 35 26 35 35 35 35 39 35 35 35 35 16 16 16 16 16 16 16 16 16 35 35 35 39 35 16 16 35 35 35 26 35 35 35 35 35 35
35 34 35 35 35 26 35 35 35 35 35 26 26 35 35 35 35 26 35 35 35 35 35 26 35 35 35 35 35 35 35 35 35 35 35 35 35 35 35 35 35 35 35 35 35 26 35 26 35 35 35 26 35 35 35 35 35 35 35 35 35 35 35 35 35 26 35 35 35 35 35 35 35 35 35 26 35 35 35 35 35 35 35 35 26 35 26 35 35 35 35 35 35 35 26 35 35 35 35 24 25 25 7 35 35 35 35 26 35 35 35 35 35 35 35 35 35 35 35 35 35 35 35 35 16 16 16 16 16 16 16 16 16 35 35 35 35 35 16 16 16 35 35 35 35 35 26 35 35 35
35 35 40 35 35 35 35 35 26 35 35 35 35 35 26 35 35 35 35 39 35 35 35 35 35 35 26 35 26 35 26 35 35 40 35 35 26 35 26 35 35 39 35 35 35 35 35 35 35 35 35 35 35 35 35 26 35 35 39 35 35 26 35 35 35 26 35 35 35 35 35 35 35 8 8 8 35 35 35 26 35 35 39 35 35 35 35 35 35 40 35 35 35 35 35 35 35 35 35 35 35 35 7 25 35 35 35 35 35 35 26 35 35 35 35 35 26 35 35 35 26 35 35 40 35 16 16 16 16 16 16 16 16 35 35 35 35 16 16 16 16 35 26 35 35 35 35 35 35 35
35 35 35 35 35 35 35 35 35 35 35 35 35 35 35 35 26 35 35 35 35 35 35 35 26 35 35 35 35 35 35 26 35 35 35 35 35 35 35 35 26 35 35 35 35 35 35 35 35 35 35 35 35 35 35 35 35 35 35 35 35 35 35 35 35 35 35 35 26 35 35 35 8 8 8 8 8 35 35 35 35 35 35 35 35 35 35 26 35 35 35 35 35 16 35 35 26 35 35 35 39 35 7 26 35 35 35 35 35 35 35 35 35 40 35 35 35 35 35 35 35 35 35 35 35 16 16 16 16 16 16 16 16 35 35 35 35 16 16 16 16 35 35 35 35 35 35 35 26 35
35 35 35 35 35 26 35 35 35 35 35 40 35 35 35 35 35 35 26 35 35 35 26 35 35 35 35 35 35 26 35 35 35 35 35 26 35 26 35 35 35 35 35 35 35 26 35 35 35 35 35 35 35 26 35 35 35 35 35 35 35 35 35 35 35 26 35 35 35 40 35 35 8 8 8 8 8 35 26 35 35 35 35 35 35 35 35 35 35 35 35 35 35 16 16 35 35 35 35 35 35 35 7 35 35 16 16 35 35 26 35 35 35 35 35 35 35 16 16 35 35 35 35 35 35 16 16 16 16 16 16 16 35 35 35 35 35 16 16 16 16 16 35 35 35 35 35 35 35 35
35 35 26 35 35 35 35 35 35 26 35 35 35 35 26 35 35 35 35 26 35 35 35 35 35 35 40 35 35 35 35 26 35 35 35 35 35 35 35 35 26 35 35 35 35 35 35 35 26 35 16 16 35 35 35 35 35 35 35 26 35 35 35 35 35 35 35 35 35 35 35 35 26 8 7 8 39 35 35 35 35 35 16 26 35 35 35 0 0 0 0 0 0 0 0 0 0 0 0 35 35 35 7 35 35 16 16 16 35 35 35 35 35 35 35 35 35 16 16 16 35 35 35 16 0 0 0 0 0 0 16 16 0 35 35 35 35 16 16 16 16 16 16 35 35 35 35 35 35 35
38 35 35 35 35 35 35 35 35 35 35 35 35 35 35 26 35 35 35 35 35 35 26 35 35 35 35 35 35 35 35 35 35 35 35 35 35 35 35 35 35 35 35 26 35 35 35 35 35 35 16 16 35 35 35 35 35 35 35 35 35 35 35 16 35 35 35 35 35 35 16 35 35 35 7 35 35 35 35 35 35 16 0 27 27 27 27 0 0 0 0 0 0 0 0 0 0 0 0 0 0 0 0 0 16 16 16 16 35 35 35 35 35 26 35 35 16 16 16 16 0 16 16 0 0 0 16 16 16 16 0 0 0 0 16 16 16 0 16 16 16 16 16 16 16 16 16 16 16 16
37 39 35 35 35 35 26 35 35 35 38 35 26 35 35 35 35 35 35 35 35 35 35 35 35 35 35 35 35 35 35 35 35 0 0 0 0 0 0 0 0 35 35 35 35 35 35 35 35 35 0 0 16 16 0 0 0 0 0 0 0 0 0 0 0 35 35 16 35 35 16 16 35 24 7 35 35 35 35 0 0 0 0 15 15 15 15 0 0 0 0 0 0 0 0 0 0 0 0 0 0 0 0 0 0 0 0 16 35 35 35 35 35 35 35 35 0 0 0 0 0 0 0 0 0 0 0 0 0 0 0 0 0 0 0 0 0 0 16 16 16 16 16 16 16 16 16 16 16 16
37 35 35 35 35 35 35 35 35 35 37 35 35 35 26 35 35 35 26 35 35 35 35 35 0 0 0 0 0 0 0 0 0 0 0 0 0 0 0 0 0 0 0 0 0 0 0 0 0 0 0 0 0 0 0 0 0 0 0 0 0 0 0 0 0 0 0 0 35 16 16 16 35 35 7 35 35 35 0 0 0 0 0 16 16 16 16 2 2 2 2 2 2 2 2 2 2 0 0 0 0 0 0 0 0 0 0 0 0 0 0 0 0 0 16 0 0 0 0 0 0 2 2 2 2 2 2 2 2 2 2 2 2 2 2 2 2 2 2 2 2 2 2 2 2 2 2 2 2 2
37 35 35 35 35 35 35 35 35 35 37 35 35 35 35 35 35 35 35 19 2 0 0 0 0 0 0 0 0 0 0 0 0 0 0 0 0 0 0 0 0 0 0 0 0 0 0 0 0 0 0 0 0 0 0 0 0 0 0 0 0 0 0 0 0 0 0 0 0 16 0 0 16 0 0 0 0 0 0 0 0 0 0 2 2 2 2 2 2 2 2 2 2 2 2 2 2 2 2 2 2 2 2 2 2 2 0 0 0 0 0 0 0 0 0 0 0 0 2 2 2 2 2 2 2 2 2 2 2 2 2 2 2 2 2 2 2 2 2 2 2 2 2 2 2 2 2 2 2 2
19 19 19 19 19 19 19 19 19 19 19 19 19 19 19 19 0 0 19 2 2 2 2 2 2 0 0 0 0 0 0 0 0 2 2 2 2 2 2 2 2 0 0 0 0 0 0 0 0 0 2 2 2 2 2 2 2 2 2 2 2 2 2 2 2 2 0 0 0 0 0 0 0 0 0 0 0 0 0 0 2 2 2 2 2 2 2 2 2 2 2 2 2 2 2 2 2 2 2 2 2 2 2 2 2 2 2 2 2 2 2 2 2 2 2 2 2 2 2 2 2 2 2 2 2 2 2 2 2 2 2 2 2 2 2 2 2 2 2 2 2 2 2 2 2 2 2 2 2 2
19 19 19 19 19 19 19 19 19 19 19 19 19 19 19 19 19 2 2 2 2 2 2 2 2 2 2 2 2 2 2 2 2 2 2 2 2 2 2 2 2 2 2 2 2 2 2 2 2 2 2 2 2 2 2 2 2 2 2 2 2 2 2 2 2 2 2 2 0 0 0 0 0 0 0 0 0 0 0 2 2 2 2 2 2 2 2 2 2 2 2 2 2 2 2 2 2 2 2 2 2 2 2 2 2 2 2 2 2 2 2 2 2 2 2 2 2 2 2 2 2 2 2 2 2 2 2 2 2 2 2 2 2 2 2 2 2 2 2 2 2 2 2 2 2 2 2 2 2 2
2 2 2 2 2 2 2 2 2 2 2 2 2 2 2 2 2 2 2 2 2 2 2 2 2 2 2 2 2 2 2 2 2 2 2 2 2 2 2 2 2 2 2 2 2 2 2 2 2 2 2 2 2 2 2 2 2 2 2 2 2 2 2 2 2 2 2 2 2 2 2 2 2 2 2 2 2 2 2 2 2 2 2 2 2 2 2 2 2 2 2 2 2 2 2 2 2 2 2 2 2 2 2 2 2 2 2 2 2 2 2 2 2 2 2 2 2 2 2 2 2 2 2 2 2 2 2 2 2 2 2 2 2 2 2 2 2 2 2 2 2 2 2 2 2 2 2 2 2 2