150 50
1 1 1 1 1 1 1 1 1 1 1 1 1 1 1 1 1 1 1 1 1 1 1 1 1 1 1 1 1 1 1 1 1 1 1 1 1 1 1 1 1 1 1 1 1 1 1 1 1 1 1 1 1 1 1 1 1 1 1 1 1 20 20 20 20 20 20 20 20 20 20 20 20 20 20 20 20 20 20 20 20 20 20 20 20 20 20 20 20 20 20 20 20 20 20 20 20 20 20 20 20 20 20 20 20 20 20 20 20 20 20 20 20 20 20 20 20 20 20 20 20 20 20 20 20 20 20 20 20 20 20 20 20 20 20 20 20 20 20 20 20 20 20 20 20 20 20 20 20 20
1 1 1 1 1 1 1 1 1 1 1 1 1 1 1 1 1 1 1 1 1 1 1 1 1 1 1 1 1 1 1 1 1 1 1 1 1 1 1 1 1 1 1 1 1 1 1 1 1 1 1 1 3 1 1 1 1 1 1 1 1 20 20 20 20 20 20 20 20 20 20 20 20 20 20 20 20 20 20 20 20 20 20 20 20 20 20 20 20 20 20 20 20 20 20 20 20 20 20 20 20 20 20 20 20 20 20 20 20 35 35 35 35 35 35 35 35 35 35 35 35 35 35 35 35 35 35 35 35 35 35 35 35 35 35 20 20 20 20 20 20 20 20 20 20 20 20 20 20 20
1 1 1 1 1 1 1 1 1 1 1 1 1 1 1 1 1 1 1 1 1 1 1 1 1 1 1 1 1 1 1 1 1 1 1 1 1 1 1 1 1 1 1 1 1 1 1 1 1 1 1 1 1 1 1 1 1 1 1 20 20 20 20 20 20 20 20 35 35 35 35 35 35 35 35 35 35 35 35 35 35 35 35 35 35 35 20 20 20 20 20 35 35 35 35 35 35 35 35 35 35 35 35 35 35 2 20 20 35 35 35 35 35 35 35 35 35 35 35 35 35 35 35 35 35 35 35 35 35 35 35 35 35 35 35 35 20 20 20 20 20 20 20 20 20 20 20 20 20 20
1 1 1 1 1 1 1 1 1 1 1 1 1 1 1 1 1 1 1 1 1 1 1 1 1 1 1 1 1 1 1 1 1 1 1 1 1 1 1 1 1 1 1 1 1 1 1 1 1 1 1 1 1 1 1 1 1 1 1 20 20 20 20 20 20 20 20 35 35 35 35 35 35 35 35 35 35 35 35 35 35 35 35 35 35 35 20 20 20 20 20 35 35 35 35 35 35 35 35 35 35 35 35 2 20 20 20 35 35 35 35 7 7 7 35 35 35 35 35 35 7 7 7 35 35 35 35 35 35 35 35 35 35 35 35 35 35 20 20 20 20 20 20 20 20 20 20 20 20 20
1 1 1 1 1 1 1 1 1 1 1 1 1 1 1 1 1 1 1 1 1 1 1 1 1 1 1 1 1 1 1 1 1 1 1 1 1 1 1 1 1 1 1 1 1 1 1 1 1 1 1 1 1 1 1 1 1 20 20 20 20 20 20 20 20 20 20 35 35 20 20 20 20 20 20 20 20 20 20 20 20 20 20 35 35 35 20 20 20 20 20 35 35 35 20 20 20 20 20 20 20 20 20 20 20 20 35 35 35 35 35 7 7 7 35 35 35 35 35 35 7 7 7 35 35 35 35 35 35 35 35 35 35 35 35 35 35 35 20 20 20 20 20 20 20 20 20 20 20 20
1 1 1 1 1 1 1 1 1 1 1 1 1 1 1 1 1 1 1 1 1 1 1 1 1 1 1 1 1 1 1 1 1 1 1 1 1 1 1 1 1 1 1 1 1 1 1 1 1 1 1 1 1 1 1 1 1 1 1 35 35 35 35 35 35 35 35 35 35 35 35 35 35 35 35 35 35 35 35 35 35 20 20 35 35 35 35 35 35 35 35 35 35 35 35 35 35 20 20 20 20 20 20 20 20 35 35 35 35 35 35 35 7 35 35 35 35 35 35 35 35 7 35 35 35 35 35 35 35 35 7 35 35 35 35 35 35 35 35 20 20 20 20 20 20 20 20 20 20 20
1 1 1 1 1 1 1 1 1 1 1 1 1 1 1 1 1 1 1 1 1 1 1 1 1 1 1 1 1 1 1 1 1 1 1 1 1 1 1 1 1 1 1 1 1 1 1 1 1 1 1 1 1 1 1 1 1 1 35 35 35 35 35 35 35 35 35 35 35 35 35 35 35 35 35 35 35 35 35 35 35 20 20 35 35 35 35 35 35 35 35 35 35 35 35 35 35 20 20 20 20 20 20 20 35 35 35 35 35 35 24 25 7 25 25 35 35 35 35 24 25 7 25 25 35 35 35 35 35 25 7 25 25 35 35 35 35 35 35 35 35 35 35 35 35 35 35 35 35 35
1 1 1 1 1 1 1 1 1 1 1 1 1 1 1 1 1 1 1 1 1 1 1 1 1 1 1 1 1 1 1 1 1 1 1 1 1 1 1 1 1 1 1 1 1 1 1 1 1 1 1 1 1 1 1 20 19 19 19 19 20 20 19 19 19 19 19 19 20 35 35 24 20 19 19 19 19 19 35 35 35 20 20 20 20 19 19 19 19 19 19 19 19 20 25 35 35 20 20 20 20 20 20 35 35 35 35 35 35 35 35 35 7 35 35 35 35 35 35 35 35 7 35 35 35 35 35 35 35 35 7 35 35 35 35 35 35 35 35 35 35 35 35 35 35 35 35 35 35 35
1 1 1 1 1 1 1 1 1 1 1 1 1 1 1 1 1 1 1 1 1 1 1 1 1 1 1 1 1 1 1 1 1 1 1 1 1 1 1 1 1 1 1 1 1 1 1 1 1 1 1 1 1 1 1 20 20 20 20 20 20 20 20 20 20 20 20 20 20 35 35 35 20 20 20 20 20 20 35 35 35 20 20 20 20 20 20 20 20 20 20 20 20 20 35 35 35 35 35 35 35 35 35 35 35 35 35 35 35 35 35 7 7 7 35 35 35 35 35 35 7 7 7 35 35 35 7 7 35 7 7 7 35 35 35 35 35 35 35 35 35 35 35 35 35 35 35 35 35 35
1 1 1 1 1 1 1 1 1 1 1 1 1 1 1 1 1 1 1 1 1 1 1 1 1 1 1 1 1 1 1 1 1 1 1 1 1 1 1 1 1 1 1 1 1 1 1 1 1 1 1 1 1 19 19 20 20 20 20 20 20 20 20 20 20 20 20 20 20 35 35 35 20 20 20 20 20 20 35 35 24 20 20 20 20 20 20 20 20 20 20 20 20 20 35 35 35 35 35 35 35 35 35 35 35 35 35 35 35 35 35 7 35 7 35 35 35 35 35 35 7 35 7 35 35 35 7 7 35 7 35 7 35 35 35 35 35 35 35 20 35 35 24 20 19 19 20 19 19 19
1 1 1 1 1 1 1 1 1 1 1 1 1 1 1 1 1 1 1 1 1 1 1 1 1 1 1 1 1 1 1 1 1 1 1 1 1 1 1 1 1 1 1 1 1 1 1 1 1 1 1 1 1 20 20 20 20 20 20 20 20 20 20 20 20 20 20 20 20 35 35 24 20 20 20 20 20 20 35 35 35 20 20 20 20 20 20 20 20 20 20 20 20 20 35 35 35 35 35 35 35 35 35 35 35 35 35 35 35 35 35 7 35 7 35 35 35 35 35 35 7 35 7 35 35 35 7 7 35 7 35 7 35 35 35 35 35 35 20 20 35 35 35 20 20 20 20 20 20 20
1 1 1 1 1 1 1 1 1 1 1 1 1 1 1 1 1 1 1 1 1 1 1 1 1 1 1 1 1 1 1 1 1 1 1 1 1 1 1 1 1 1 1 1 1 1 1 1 1 1 1 19 19 20 20 20 20 20 20 20 20 20 20 20 20 35 35 35 35 35 35 35 20 20 20 20 20 20 35 35 35 20 20 20 20 20 20 20 20 20 20 20 20 20 20 19 19 19 19 19 19 19 19 20 19 19 19 19 19 20 20 20 20 20 19 20 19 19 19 19 19 19 20 20 20 20 19 19 19 19 19 19 19 20 20 20 19 19 20 20 35 35 35 20 20 20 20 20 20 20
1 1 1 1 1 1 1 1 1 1 1 1 1 1 1 1 1 1 1 1 1 1 1 1 1 1 1 1 1 1 1 1 1 1 1 1 1 1 1 1 1 1 1 1 1 1 1 1 1 1 1 20 20 20 20 20 20 20 20 20 20 20 20 20 20 35 35 35 35 35 35 35 20 20 20 20 20 20 35 35 35 20 20 20 20 20 20 20 20 20 20 20 20 20 20 20 20 20 20 20 20 20 20 20 20 20 20 20 20 20 20 20 20 20 20 20 20 20 20 20 20 20 20 20 20 20 20 20 20 20 20 20 20 20 20 20 20 20 20 20 35 35 35 20 20 20 20 20 20 20
1 1 1 1 1 1 1 1 1 1 1 1 1 1 1 1 1 1 1 1 1 1 1 1 1 1 1 1 1 1 1 1 1 1 1 1 1 1 1 1 1 1 1 1 1 1 1 1 1 19 19 20 20 20 20 20 20 20 20 20 20 20 20 20 20 35 35 35 35 35 35 35 20 20 20 20 20 20 35 35 24 20 20 20 20 20 20 20 20 20 20 20 20 20 20 20 20 20 20 20 20 20 20 20 20 20 20 20 20 20 20 20 20 20 20 20 20 20 20 20 20 20 20 20 20 20 20 20 20 20 20 20 20 20 20 20 20 20 20 20 35 35 35 20 20 20 20 20 20 20
1 1 1 1 1 1 1 1 1 1 1 1 1 1 1 1 1 1 1 1 1 1 1 1 1 1 1 1 1 1 1 1 1 1 1 1 1 1 1 1 1 1 1 1 1 1 1 1 1 20 20 20 20 20 20 20 20 20 20 20 20 20 20 20 20 25 35 35 20 19 19 19 20 20 20 20 20 20 35 35 35 20 20 20 20 20 20 20 20 20 20 20 20 20 20 20 20 20 20 20 20 20 20 20 20 20 20 20 20 20 20 20 20 20 20 20 20 20 20 20 20 20 20 20 20 20 20 20 20 20 20 20 20 20 20 20 20 20 20 20 35 35 35 20 20 20 20 20 20 20
1 1 1 1 1 1 1 1 1 1 1 1 1 1 1 1 1 1 1 1 1 1 1 1 1 1 1 1 1 1 1 1 1 1 1 1 1 1 1 1 1 1 1 1 1 1 1 20 20 20 20 20 20 20 20 20 20 20 20 20 20 20 20 20 20 35 35 35 20 20 20 20 20 20 20 20 20 20 35 35 35 20 20 20 20 20 20 20 20 20 20 35 35 35 35 35 35 35 35 35 35 35 35 35 35 35 35 35 35 35 35 35 35 35 35 35 20 20 20 20 20 20 20 20 20 20 20 20 20 20 20 20 20 20 20 20 20 20 20 20 35 35 35 20 20 20 20 20 20 20
1 1 1 1 1 1 1 1 1 1 1 1 1 1 1 1 1 1 1 1 1 1 1 1 1 1 1 1 1 1 1 1 1 1 1 1 1 1 1 1 1 1 1 1 1 1 1 20 20 20 20 20 20 20 20 20 20 20 20 20 20 20 20 20 20 35 35 35 20 20 20 20 20 20 20 20 20 20 35 35 35 20 20 20 20 20 20 20 20 20 20 35 35 35 35 35 35 35 35 35 35 35 35 35 35 35 35 35 35 35 35 35 35 35 35 35 20 20 20 20 20 20 20 20 20 20 20 20 20 20 20 20 20 20 20 20 20 20 20 20 35 35 24 20 20 20 20 20 20 20
1 1 1 1 1 1 1 1 1 1 1 1 1 1 1 1 1 1 1 1 1 1 1 1 1 1 1 1 1 1 1 1 1 1 1 1 1 1 1 1 1 1 1 1 1 20 19 20 20 20 20 20 20 20 20 20 20 20 20 20 20 20 20 20 20 25 35 35 20 20 20 20 20 20 20 20 20 20 35 35 24 20 20 20 20 20 20 20 20 20 20 35 35 35 35 35 35 35 35 35 35 35 35 35 35 35 35 35 35 35 35 35 35 35 35 35 20 20 20 20 20 20 20 20 20 20 20 35 35 35 35 35 35 35 35 35 35 35 35 35 35 35 35 20 20 20 20 20 20 20
1 1 1 1 1 1 1 1 1 1 1 1 1 1 1 1 1 1 1 1 1 1 1 1 1 1 1 1 1 1 1 1 1 1 1 1 1 1 1 1 1 1 1 1 1 20 20 20 20 20 20 20 20 20 20 20 20 20 35 35 35 35 35 35 35 35 35 35 35 35 35 35 35 35 35 35 35 35 35 35 35 35 35 35 35 35 35 20 20 20 20 35 35 35 35 35 35 35 35 35 35 35 35 35 35 35 35 35 35 35 35 35 35 35 35 35 20 20 20 20 20 20 20 20 20 20 20 35 35 35 35 35 35 35 35 35 35 35 35 35 35 35 35 20 20 20 20 20 20 20
1 1 1 1 1 1 1 1 1 1 1 1 1 1 1 1 1 1 1 1 1 1 1 1 1 1 1 1 1 1 1 1 1 1 1 1 1 1 1 1 1 1 1 19 20 20 20 20 20 20 20 20 20 20 20 20 20 20 35 35 35 35 35 35 35 35 35 35 35 35 35 35 35 35 35 35 35 35 35 35 35 35 35 35 35 35 35 20 20 20 20 35 35 35 35 35 35 35 35 35 35 35 35 35 35 35 35 35 35 35 35 35 35 35 35 35 20 20 20 20 20 20 20 20 20 20 20 35 35 35 35 35 35 35 35 35 35 35 35 35 35 35 35 20 20 20 20 20 20 20
1 1 1 1 1 1 1 1 1 1 1 1 1 1 1 1 1 1 1 1 1 1 1 1 1 1 1 1 1 1 1 1 1 1 1 1 1 1 1 1 1 1 1 20 20 20 20 20 20 20 20 20 20 20 20 20 20 20 35 35 35 35 35 35 35 35 35 35 35 35 35 35 35 35 35 35 35 35 35 35 35 35 35 35 35 35 35 20 20 20 20 35 35 35 35 35 35 35 35 35 35 35 35 35 35 35 35 35 35 35 35 35 35 35 35 35 20 20 20 20 20 20 20 20 20 20 20 25 25 25 20 20 20 19 19 19 19 19 20 20 20 20 19 20 20 20 20 20 20 20
1 1 1 1 1 1 1 1 1 1 1 1 1 1 1 1 1 1 1 1 1 1 1 1 1 1 1 1 1 1 1 1 1 1 1 1 1 1 1 1 1 19 20 20 20 20 20 20 20 20 20 20 20 20 20 20 20 20 35 35 35 19 19 19 19 19 19 19 20 35 35 35 20 19 19 19 19 19 19 19 19 19 19 20 35 35 35 20 20 20 20 35 35 35 35 35 35 35 35 35 35 16 16 16 35 35 35 35 35 35 35 35 35 35 35 35 20 20 20 20 20 20 20 20 20 20 20 35 35 35 20 20 20 20 20 20 20 20 20 20 20 20 20 20 20 20 20 20 20 20
1 1 1 1 1 1 1 1 1 1 1 1 1 1 1 1 1 1 1 1 1 1 1 1 1 1 1 1 1 1 1 1 1 1 1 1 1 1 1 1 1 20 20 20 20 20 20 20 20 20 20 20 20 20 20 20 20 20 25 35 35 20 20 20 20 20 20 20 20 35 35 35 20 20 20 20 20 20 20 20 20 20 20 20 35 35 35 20 20 20 20 35 35 35 35 35 35 35 35 35 35 16 16 16 35 35 35 35 35 35 35 35 35 35 35 35 20 20 20 20 20 20 20 20 20 20 20 35 35 35 20 20 20 20 20 20 20 20 20 20 20 20 20 20 20 20 20 20 20 20
1 1 1 1 1 1 1 1 1 1 1 1 1 1 1 1 1 1 1 1 1 1 1 1 1 1 1 1 1 1 1 1 1 1 1 1 1 1 1 20 20 20 20 20 20 20 20 20 20 20 20 20 20 35 35 35 35 35 35 35 35 20 20 20 20 20 20 20 20 35 35 24 20 20 20 20 20 20 20 20 20 20 20 20 35 35 35 20 20 20 20 35 35 35 35 35 35 35 35 16 16 16 16 16 16 16 35 35 35 35 35 35 35 35 35 35 20 20 20 20 20 20 20 20 20 20 20 35 35 35 20 20 20 20 20 20 20 20 20 20 20 20 20 20 20 20 20 20 20 20
1 1 1 1 1 1 1 1 1 1 1 1 1 1 1 1 1 1 1 1 1 1 1 1 1 1 1 1 1 1 1 1 1 1 1 1 1 1 1 20 20 20 20 20 20 20 20 20 20 20 20 20 20 35 35 35 35 35 35 35 35 20 20 20 20 20 35 35 35 35 35 35 20 20 20 20 20 20 20 20 20 20 20 20 35 35 35 20 20 20 20 35 35 35 35 35 35 35 35 16 35 35 35 35 35 16 35 35 35 35 35 35 35 35 35 35 20 20 20 20 20 20 20 20 20 20 20 35 35 24 20 20 20 20 20 20 20 20 20 20 20 20 20 20 20 20 20 20 20 20
1 1 1 1 1 1 1 1 1 1 1 1 1 1 1 1 1 1 1 1 1 1 1 1 1 1 1 1 1 1 1 1 1 1 1 1 1 20 20 20 20 20 20 20 20 20 20 20 20 20 20 20 35 35 35 35 35 35 35 35 35 20 20 20 20 20 35 35 35 35 35 35 20 20 20 20 20 20 20 20 20 20 20 20 35 35 35 35 35 35 35 35 35 35 35 35 35 16 16 16 35 35 35 35 35 16 16 16 35 35 35 35 35 35 35 35 35 35 35 35 35 35 35 35 35 35 35 35 35 35 35 35 35 35 35 35 35 35 35 35 35 35 35 35 35 35 35 35 35 35
1 1 1 1 1 1 1 1 1 1 1 1 1 1 1 1 1 1 1 1 1 1 1 1 1 1 1 1 1 1 1 1 1 1 1 1 1 20 20 20 20 20 20 20 20 20 20 20 20 20 20 20 27 27 27 19 19 19 19 19 19 20 20 20 20 20 35 35 35 35 35 35 20 20 20 20 20 20 20 20 20 20 20 20 35 35 35 35 35 35 35 35 35 35 35 35 35 16 16 35 35 35 35 35 35 35 35 35 35 35 35 35 35 35 35 35 35 35 35 35 35 35 35 35 35 35 35 35 35 35 35 35 35 35 35 35 35 35 35 35 35 35 35 35 35 35 35 35 35 35
1 1 1 1 1 1 1 1 1 1 1 1 1 1 1 1 1 1 1 1 1 1 1 1 1 1 1 1 1 1 1 1 1 1 1 19 20 20 20 20 20 20 20 20 20 20 20 20 20 20 20 20 15 15 15 20 20 20 20 20 20 20 20 20 20 20 35 35 35 20 19 19 20 20 20 20 20 20 20 20 20 20 20 20 35 35 35 35 35 35 35 35 35 35 35 16 16 16 16 35 35 35 35 35 35 35 16 16 16 16 35 35 35 35 35 35 35 35 35 35 35 35 35 35 35 35 35 35 35 35 35 35 35 35 35 35 35 35 35 35 35 35 35 35 35 35 35 35 35 35
1 1 1 1 1 1 1 1 1 1 1 1 1 1 1 1 1 1 1 1 1 1 1 1 1 1 1 1 1 1 1 1 1 1 1 20 20 20 20 20 20 20 20 20 20 20 20 20 20 20 20 20 20 20 20 20 20 20 20 20 20 20 20 20 20 20 35 35 35 20 20 20 20 20 20 20 20 20 20 20 20 20 20 20 20 19 19 19 19 20 20 19 19 16 16 16 16 16 16 20 19 19 20 20 19 20 16 16 16 16 16 16 20 20 20 19 19 19 20 35 35 24 20 19 19 19 20 35 35 24 20 19 19 20 35 35 35 35 35 35 35 35 35 35 35 35 20 20 20 20
1 1 1 1 1 1 1 1 1 1 1 1 1 1 1 1 1 1 1 1 1 1 1 1 1 1 1 1 1 1 1 1 1 20 20 20 20 20 20 20 20 20 20 20 20 20 20 20 20 20 20 20 20 20 20 20 20 20 20 20 20 20 20 20 20 20 25 35 35 20 20 20 20 20 20 20 20 20 20 20 20 20 20 20 20 20 20 20 20 20 20 20 20 20 20 20 20 20 20 20 20 20 20 20 20 20 20 20 20 20 20 20 20 20 20 20 20 20 20 35 35 35 20 20 20 20 20 35 35 35 20 20 20 20 35 35 35 35 35 35 35 35 35 35 35 35 20 20 20 20
1 1 1 1 1 1 1 1 1 1 1 1 1 1 1 1 1 1 1 1 1 1 1 1 1 1 1 1 1 1 1 1 1 20 20 20 20 20 20 20 20 20 20 20 20 20 20 20 20 20 20 20 20 20 20 20 20 20 20 20 35 35 35 35 35 35 35 35 35 35 35 35 35 20 20 20 20 20 20 20 20 20 20 20 20 20 20 20 20 20 20 20 20 20 20 20 20 20 20 20 20 20 20 20 20 20 20 20 20 20 20 20 20 20 20 20 20 20 20 35 35 35 20 20 20 20 20 35 35 35 20 20 20 20 19 35 35 35 35 35 35 35 35 35 35 20 20 20 20 20
1 1 1 1 1 1 1 1 1 1 1 1 1 1 1 1 1 1 1 1 1 1 1 1 1 1 1 1 1 1 1 20 20 20 20 20 20 20 20 20 20 20 20 20 20 35 35 35 35 35 35 35 35 35 35 35 35 35 35 35 35 35 35 35 35 35 35 35 35 35 35 35 35 20 20 20 20 20 20 20 20 20 20 20 20 20 20 20 20 20 20 20 20 20 20 20 20 20 20 20 20 20 20 20 20 20 20 20 20 20 20 20 20 20 20 20 20 20 20 35 35 24 20 20 20 20 20 35 35 35 20 20 20 20 20 20 35 35 35 35 35 35 35 35 20 20 20 20 20 20
1 1 1 1 1 1 1 1 1 1 1 1 1 1 1 1 1 1 1 1 1 1 1 1 1 1 1 1 1 1 1 20 20 20 20 20 20 20 20 20 20 20 20 20 35 35 35 35 35 35 35 35 35 35 35 35 35 35 35 35 35 35 35 35 35 35 35 35 35 35 35 35 35 20 20 20 20 20 20 20 35 35 35 35 35 35 35 35 35 35 35 35 35 20 20 20 20 20 20 20 20 20 20 20 20 20 20 20 20 20 20 20 20 20 20 20 20 20 20 35 35 35 20 20 20 20 20 35 35 24 20 20 20 20 20 20 20 19 19 19 20 19 19 20 20 20 20 20 20 20
1 1 1 1 1 1 1 1 1 1 1 1 1 1 1 1 1 1 1 1 1 1 1 1 1 1 1 1 1 19 19 20 20 20 20 20 20 20 20 20 20 20 20 35 35 35 35 35 35 35 35 35 35 35 35 35 35 35 35 35 35 35 35 35 35 19 19 19 19 20 35 35 35 20 20 20 20 20 20 35 35 35 35 35 35 35 35 35 35 35 35 35 35 35 20 20 20 20 20 20 20 20 20 20 20 20 20 20 20 20 20 20 20 20 20 20 20 20 20 35 35 35 20 20 20 20 20 35 35 35 20 20 20 20 20 20 20 20 20 20 20 20 20 20 20 20 20 20 20 20
1 1 1 1 1 1 1 1 1 1 1 1 1 1 1 1 1 1 1 1 1 1 1 1 1 1 1 1 1 20 20 20 20 20 20 20 20 20 20 20 20 20 35 35 35 35 35 35 35 35 8 8 8 35 35 35 35 35 35 35 35 35 35 19 19 20 20 20 20 20 35 35 35 20 20 20 20 20 35 35 35 35 35 35 35 35 35 35 35 35 35 35 35 35 35 20 20 20 20 20 20 20 20 20 20 20 20 20 20 20 20 20 20 20 20 20 20 20 20 35 35 35 20 20 20 20 20 35 35 35 20 20 20 20 20 20 20 20 20 20 20 20 20 20 20 20 20 20 20 20
1 1 1 1 1 1 1 1 1 1 1 1 1 1 1 1 1 1 1 1 1 1 1 1 1 1 1 20 20 20 20 20 20 20 20 20 20 20 20 20 20 35 35 35 35 35 35 35 35 8 8 8 8 8 35 35 35 35 35 35 35 19 19 20 20 20 20 20 20 20 35 35 35 35 35 35 35 35 35 35 35 35 35 35 35 35 35 35 35 35 35 35 35 35 35 35 20 20 20 20 20 20 20 20 20 20 20 20 20 20 20 20 20 20 20 20 20 20 20 35 35 24 20 20 20 20 20 35 35 35 20 20 20 20 20 20 20 20 20 20 20 20 20 20 20 20 20 20 20 20
1 1 1 1 1 1 1 1 1 1 1 1 1 1 1 1 1 1 1 1 1 1 1 1 1 1 1 20 20 20 20 20 20 20 20 20 20 20 20 20 20 35 35 35 35 35 35 35 35 8 8 8 8 8 35 35 35 35 35 20 19 20 20 20 20 20 20 20 20 20 35 35 35 35 35 35 35 35 35 35 35 35 35 35 35 35 35 35 35 35 35 35 35 35 35 35 35 35 35 35 35 35 35 35 35 35 35 35 35 35 35 35 35 35 35 35 35 35 35 35 35 35 20 20 20 20 20 35 35 35 20 20 20 20 20 20 20 20 20 20 20 20 20 20 20 20 20 20 20 20
1 1 1 1 1 1 1 1 1 1 1 1 1 1 1 1 1 1 1 1 1 1 1 1 1 20 19 20 20 20 20 20 20 20 20 20 20 20 20 20 20 35 35 35 35 35 35 35 8 8 8 8 8 8 8 35 35 35 35 20 20 20 20 20 20 20 20 20 20 20 35 35 35 35 35 35 35 35 35 7 35 35 35 35 35 35 35 35 35 7 35 35 35 35 35 35 35 35 35 35 35 35 35 35 35 35 35 35 35 35 35 35 35 35 35 35 35 35 35 35 35 35 20 20 20 20 20 35 35 35 20 20 20 20 20 20 20 20 20 20 20 20 20 20 20 20 20 20 20 20
1 1 1 1 1 1 1 1 1 1 1 1 1 1 1 1 1 1 1 1 1 1 1 1 1 20 20 20 20 20 20 20 20 20 20 20 20 20 20 20 20 35 35 35 35 35 35 35 35 35 8 7 8 35 35 35 35 35 35 20 20 20 20 20 20 20 20 20 20 20 35 35 35 35 35 35 35 35 35 7 35 35 35 35 35 35 35 35 35 7 35 35 35 35 35 35 35 35 35 35 35 35 35 35 35 35 35 35 35 35 35 35 35 35 35 35 35 35 35 35 35 35 20 20 20 20 20 35 35 35 35 7 35 35 35 35 7 35 35 35 35 7 35 35 35 35 7 35 35 20
1 1 1 1 1 1 1 1 1 1 1 1 1 1 1 1 1 1 1 1 1 1 1 20 19 20 20 20 20 20 20 20 20 20 20 20 20 20 20 20 20 25 35 35 35 35 35 35 35 35 24 7 35 35 35 35 35 35 20 20 20 20 20 20 20 20 20 20 20 20 0 0 0 0 0 0 0 0 0 0 0 0 0 0 0 0 0 0 0 0 0 0 0 0 0 0 20 35 35 24 20 20 35 35 35 35 35 35 35 35 35 35 35 35 35 20 19 19 20 20 25 25 20 20 20 20 20 35 35 35 35 16 35 35 35 35 16 35 35 35 35 35 35 35 35 35 16 35 35 20
1 1 1 1 1 1 1 1 1 1 1 1 1 1 1 1 1 1 1 1 1 1 1 20 20 20 20 20 20 20 20 20 20 20 20 20 20 20 20 20 20 35 35 35 20 20 35 35 35 35 35 7 35 35 35 35 35 35 20 20 20 20 20 20 20 20 20 20 20 20 20 20 20 20 20 20 20 20 20 20 20 20 20 20 20 20 20 20 20 20 20 20 20 20 20 20 20 35 35 35 20 20 20 35 35 35 35 35 35 35 35 35 35 35 20 20 20 20 20 20 35 35 20 20 20 20 20 35 35 35 16 16 16 35 35 16 16 16 35 35 35 35 35 35 35 16 16 16 35 20
1 1 1 1 1 1 1 1 1 1 1 1 1 1 1 1 1 1 1 1 1 19 20 20 20 20 20 20 20 20 20 20 20 20 20 20 20 20 20 20 20 35 35 35 20 20 35 35 35 35 35 7 35 35 35 35 35 35 20 20 20 20 20 20 20 20 20 20 20 20 20 20 20 20 20 20 20 20 20 20 20 20 20 20 20 20 20 20 20 20 20 20 20 20 20 20 20 35 35 35 20 20 20 20 35 35 35 35 35 35 35 35 35 20 20 20 20 20 20 20 35 35 20 20 20 20 20 35 35 35 35 16 35 35 35 35 16 35 35 35 35 35 35 35 35 35 16 35 35 20
1 1 1 1 1 1 1 1 1 1 1 1 1 1 1 1 1 1 1 1 1 20 20 20 20 20 20 20 20 20 20 20 20 20 20 20 20 20 20 20 20 25 35 35 20 20 0 0 0 0 0 0 0 0 0 0 0 0 20 20 20 20 20 20 20 20 20 20 20 20 20 20 20 20 20 20 20 20 20 20 20 20 20 20 20 20 20 20 20 20 20 20 20 20 20 20 20 35 35 35 20 20 20 20 20 19 19 19 19 20 20 20 20 20 20 20 20 20 20 20 25 25 20 20 20 20 20 35 35 35 35 35 35 35 35 35 35 35 35 35 35 35 35 35 35 35 35 35 35 20
1 1 1 1 1 1 1 1 1 1 36 1 1 1 1 1 1 1 1 20 20 20 20 20 20 20 20 20 20 20 20 20 20 20 20 20 20 20 20 20 20 35 35 35 20 20 2 2 2 2 2 2 2 2 2 2 2 2 20 20 20 20 20 20 20 20 20 20 20 20 20 20 20 20 35 35 35 35 35 35 35 35 35 35 35 20 20 20 20 20 20 20 20 20 20 20 20 35 35 24 20 20 20 20 20 20 20 20 20 20 20 20 20 20 20 20 20 20 20 20 35 35 20 20 20 20 20 35 35 35 35 35 35 35 35 35 35 35 35 35 35 35 35 35 35 35 35 35 35 20
1 1 1 1 1 1 1 1 1 1 37 1 1 1 1 1 1 1 1 20 20 20 20 20 20 20 20 20 20 20 20 20 20 20 20 20 20 20 20 20 20 35 35 35 20 20 20 20 20 20 20 20 20 20 20 20 20 20 20 20 20 20 20 20 20 20 20 20 20 35 35 35 35 35 35 35 35 35 35 35 35 35 35 35 35 35 35 35 35 35 20 20 20 20 20 20 20 35 35 35 20 20 20 20 20 20 20 20 20 20 20 20 20 20 20 20 20 20 20 20 35 35 20 20 20 20 20 35 35 35 35 35 35 35 35 35 35 35 35 35 35 35 35 35 35 35 35 35 35 20
1 1 1 1 1 1 1 36 1 1 37 1 1 1 1 1 1 19 20 20 20 20 20 20 20 20 20 20 20 20 20 20 20 20 20 20 20 20 20 20 20 25 35 35 20 20 20 20 20 20 20 20 20 20 20 20 20 20 20 20 20 20 20 20 20 35 35 35 35 35 35 35 35 35 35 35 35 35 35 35 35 35 35 35 35 35 35 35 35 35 35 20 20 20 20 20 20 35 35 35 20 20 20 20 20 20 20 20 20 20 20 20 20 20 20 20 20 20 20 20 25 25 20 20 20 20 20 35 35 35 35 35 35 35 35 35 35 35 35 35 35 35 35 35 35 35 35 35 35 35
1 1 1 1 1 1 1 37 1 1 37 1 1 1 1 1 1 20 20 20 20 20 20 20 20 20 20 20 20 20 20 20 20 20 20 20 20 35 35 35 35 35 35 35 35 35 35 35 35 35 35 35 35 35 35 35 35 35 35 35 35 35 35 35 35 35 35 35 35 35 35 35 35 35 35 35 35 35 35 35 35 35 35 35 35 35 35 35 35 35 35 35 35 35 20 20 20 35 35 35 20 20 20 20 20 20 20 20 20 20 20 20 20 20 20 20 20 20 20 20 35 35 35 35 35 35 35 35 35 35 35 35 35 35 35 35 35 35 35 35 35 16 35 35 35 35 35 35 35 35
36 1 1 1 1 19 19 19 19 19 19 19 1 1 1 20 20 20 20 20 20 20 20 20 20 20 20 20 20 20 20 20 20 20 20 20 20 35 35 35 35 35 35 35 35 35 35 35 35 35 35 35 35 35 35 35 35 35 35 35 35 35 35 35 35 35 35 35 35 35 35 35 35 35 35 35 35 35 35 35 35 35 35 35 35 35 35 35 35 35 35 35 35 35 35 35 35 35 35 24 20 20 20 20 20 20 20 20 20 20 20 20 20 20 20 20 20 20 20 20 35 35 35 35 35 35 35 35 35 35 35 35 35 35 35 35 35 35 35 35 16 16 16 35 35 35 35 35 35 35
19 19 19 19 19 19 19 19 19 19 19 19 19 19 19 19 19 19 19 19 19 19 19 19 19 19 19 19 19 20 20 20 20 20 20 20 20 35 35 35 35 35 35 35 35 35 35 35 35 35 35 35 35 35 35 35 35 35 35 35 35 35 35 35 35 35 35 35 35 35 35 35 35 35 35 35 35 35 35 35 35 35 35 35 35 35 35 35 35 35 35 35 35 35 35 35 35 35 35 35 20 20 20 20 20 20 20 20 20 20 20 20 20 20 20 20 20 20 20 20 20 19 19 20 20 19 19 0 0 0 0 0 0 0 0 0 0 0 0 0 0 16 0 0 0 0 0 0 20 19
19 19 19 19 19 19 19 19 19 19 19 19 19 19 19 19 19 19 19 19 19 19 19 19 19 19 19 19 19 20 20 20 20 20 20 20 20 19 19 19 19 19 19 19 19 19 19 19 19 19 19 19 19 27 27 27 27 27 27 27 27 27 27 27 27 27 27 27 27 27 27 27 27 27 27 27 27 27 27 27 27 27 27 27 27 27 27 27 27 27 27 19 19 19 19 19 19 19 19 19 20 20 20 20 20 20 20 20 20 20 20 20 20 20 20 20 20 20 20 20 20 20 20 20 20 20 20 20 20 20 20 20 20 20 20 20 20 20 20 20 20 20 20 20 20 20 20 20 20 20