17 12
7 1 1 1 1 1 1 1 1 1 1 1 1 1 1 1 7
7 11 11 11 11 11 11 7 7 7 11 11 11 11 11 11 7
7 1 1 1 1 1 1 1 1 1 1 1 1 1 1 1 7
7 1 1 1 1 1 1 1 1 7 7 7 7 7 7 11 7
7 1 1 1 1 1 1 1 1 7 35 35 35 35 7 1 7
7 1 1 1 1 1 1 1 1 7 35 35 35 35 7 1 7
7 1 1 1 1 1 1 1 1 7 35 35 35 35 7 1 7
7 1 1 1 1 1 1 1 1 7 35 35 35 35 7 1 7
7 1 1 1 1 1 1 1 1 7 35 35 35 35 7 1 7
7 1 1 1 1 1 1 1 1 7 7 7 7 7 7 11 7
7 1 1 1 1 1 1 1 1 1 1 1 1 1 1 1 7
16 17 17 17 17 17 17 17 17 17 17 17 17 17 17 17 16